偎	亻田一󰀖
绽	纟宀一󰁾
梏	木丿土口
颏	亠ㄥ丿贝
冗	冖几󰀅
份	亻八刀
悟	忄五口󰀝
噤	口木木小
肟	月二ㄅ󰁀
纥	纟𠂉乙󰁀
鼬	臼󰁐󰁦由
亥	亠ㄥ丿人
渴	氵日勹󰄃
愣	忄罒方
薇	艹彳山夂
文	文丶一󰂃
临	〢𠂉丶󰀱
医	匚𠂉大󰀦
鄣	立早阝󰀢
曼	日罒又󰁧
炎	火火󰁧
橐	一口丨木
伽	亻力口
们	亻门󰁀
皤	白丿米田
蚤	又丶虫󰁧
荻	艹犭ノ火
捻	扌人丶心
镇	钅十󰀣八
汀	氵丁󰀢
籀	⺮扌󰁚田
巴	巴󰁈丨乚
酣	西一艹二
澈	氵亠厶夂
夏	丆目夂󰁧
侈	亻夕夕󰁶
载	十戈车
郎	丶彐厶阝
胎	月厶口󰀝
藤	艹月䒑氺
痤	疒人人土
感	厂一口心
嗤	口凵丨虫
箐	⺮主月󰀘
抻	扌日丨󰀢
隳	阝工⺗
麴	木人人米
患	口口丨心
螬	虫一ㄇ日
彭	士口䒑彡
傣	亻三人氺
那	刀二阝󰀢
吇	口子󰀝
徽	彳山一夂
靼	廿󰀜曰一
蝼	虫米女󰀝
羽	羽𠃌丶󰀞
杼	木󰁻乛亅
瘤	疒󰁚丶田
嘤	口贝贝女
様	木丷王水
狻	犭ノ厶夂
苻	艹亻寸󰁧
蛳	虫リ一丨
睬	目爫木󰁶
曳	日󰅅󰀏
徭	彳爫󰅎山
淀	氵宀一󰁾
年	󰅎丨十󰀵
菇	艹女古󰀘
椐	木尸古󰀝
忽	勹󰁤心󰁧
格	木夂口󰀝
砼	石人工󰀝
蠼	虫目目又
芗	艹󰁲丿󰁣
坤	土日丨󰀢
侥	亻弋丿儿
熟	󰁸孑九灬
蝤	虫丷西一
嘻	口士口口
忭	忄亠卜󰁶
砬	石立󰀝
瀣	氵󰀥夕一
鬈	󰂞彡丷⺋
俭	亻人一一
阻	阝󰀐一󰀝
冏	冂八口󰀌
膏	󰁸冖口月
熏	丿一󰀹灬
孀	女󰀙木目
扇	丶尸羽󰀌
佥	人一󰀧一
垤	土一厶土
噻	口宀󰀀土
柬	一󰀹󰅇󰀦
片	丿丨一󰁈
恣	冫⺈人心
魈	白󰁜厶月
虻	虫亠󰄃󰁀
登	癶一口䒑
骐	󰀊󰀞艹八
檐	木⺈厂言
囤	囗一凵乚
伥	亻丿七󰂃
袼	衤󰁧夂口
题	日一󰁾贝
蛤	虫人一口
碘	石ㄇ󰁺八
戟	十日十戈
喻	口人一刂
疳	疒艹二󰀌
锇	钅丿扌丶
骈	󰀊󰀞䒑廾
箴	⺮厂一丶
喳	口木日一
戏	又戈󰁶
胗	月人彡ノ
郗	乂冂阝
哇	口土土󰀝
以	󰁐丶人󰁶
顼	王丆贝󰁶
硼	石月月󰀝
裘	一氺丶󰀔
黥	󰀹土灬小
滥	氵〢𠂉皿
绥	纟爫女󰀝
闳	门厶󰀦
衬	衤󰁧寸󰁶
硬	石一日乂
量	日一日土
藻	艹氵口木
减	冫厂一丶
闻	门耳󰀌
礼	礻󰁶乚󰁀
破	石󰅌又󰁶
师	リ一冂丨
丈	󰂃󰀦
率	亠ㄠ󰀪十
掇	扌又又又
随	阝月辶
埘	土日寸󰁶
申	日丨󰀵
言	言言言言
螗	虫广󰁬口
羙	丷王火󰁧
茫	艹氵亠󰄃
裼	衤󰁧日󰁤
柴	止匕木󰁧
么	丿厶󰁧
晏	日宀女󰀘
棼	木木八刀
升	丿廾󰀵
枘	木冂人󰁶
卫	ㄗ一󰀌
镳	钅广󰁃灬
鞘	廿󰀜⺌月
这	文辶󰀦
列	一夕刂󰀢
戗	人⺋戈󰁶
馐	⺈󰁐䒑二
傻	亻丿囗夂
悻	忄土䒑十
炻	火石󰀝
霏	󰀙丨三三
邻	人丶󰁻阝
消	氵⺌月󰀝
咳	口亠ㄥ人
劫	土厶力ノ
披	扌󰅌又󰁶
简	⺮门日󰀘
钳	钅艹二󰀝
芫	艹二儿󰀅
颤	亠囗口贝
姐	女󰀐一󰀝
槐	木白󰁜厶
觐	廿口主󰁜
僻	亻尸口辛
楼	木米女󰀝
凇	冫木八厶
桴	木爫子󰀝
蛏	虫又土󰀝
雏	⺈彐亻󰁷
饼	⺈󰁐䒑廾
緈	糹土䒑十
哳	口扌斤󰀢
桤	木山己󰁀
诀	讠ユ人󰁶
采	爫木󰁧
苫	艹󰀥口󰀘
砘	石一凵乚
伐	亻
娼	女日日󰀝
稼	禾宀一󰀓
领	人丶󰁻贝
梆	木三丿阝
椤	木罒夕󰁶
贴	贝󰀥口󰀝
吻	口勹󰁤ノ
夤	夕宀一八
颗	日木丆贝
碗	石宀夕⺋
梗	木一日乂
琳	王木木󰁶
佐	亻工󰀝
彐	彐󰁈一一
坏	土丆卜󰁶
杏	木口󰀘
逅	⺁一口辶
者	土丿日󰀘
怅	忄丿七󰂃
姬	女匚丨丨
给	纟人一口
扫	扌彐󰀝
借	亻󰁺日󰀝
呻	口日丨󰀢
肖	⺌月󰀘
齐	文󰀯󰀬
悖	忄十冖子
硗	石弋丿儿
葳	艹厂一丶
栏	木丷三󰀝
窀	宀八一乚
指	扌匕日󰀝
骀	󰀊󰀞厶口
茇	艹又丶
骼	󰀾月夂口
去	土厶󰁧
窬	宀八人刂
玻	王󰅌又󰁶
缙	纟一󰅊日
鼙	士口䒑十
莳	艹日寸󰁧
朗	丶彐厶月
蜗	虫口冂人
埏	土丿止廴
怎	𠂉丨二心
勇	󰁻用力
拇	扌母󰁶
苇	艹二𠃌丨
髀	󰀾月白十
驼	󰀊󰀞宀匕
浴	氵八人口
嵴	山󰀪人月
橼	木纟󰅂󰀓
蜘	虫𠂉大口
马	󰀊一󰀌
囗	囗丨󰁈一
盗	冫⺈人皿
妇	女彐󰀝
箭	⺮䒑月刂
锣	钅罒夕󰁶
咏	口丶𠃌󰀩
腆	月ㄇ󰁺八
唣	口白七󰁀
艴	弓󰀯⺈巴
钏	钅川󰀢
谈	讠火火󰁶
痘	疒一口䒑
嶙	山米夕丨
愫	忄主ㄠ小
茳	艹氵工󰀘
奇	大丁口󰀘
镣	钅大丷小
屈	尸凵山󰀵
芴	艹勹󰁤󰁣
驵	󰀊󰀞󰀐一
镗	钅⺌冖土
秤	禾一丷十
淙	氵宀二小
八	八丿󰂃
荳	艹一口䒑
徐	彳人一木
标	木二小󰁶
堇	廿口主󰀘
咣	口⺌一儿
甏	士口䒑丶
致	一厶土夂
守	宀寸󰁧
钣	钅⺁又󰁶
骤	󰀊󰀞耳乑
锏	钅门日󰀝
噘	口厂䒑人
悫	士冖几心
炫	火亠ㄠ󰁶
肫	月一凵乚
砗	石车󰀢
栗	覀木󰁧
辐	车一口田
逆	䒑凵丿辶
俐	亻禾刂󰀢
忐	上心󰁧
瓣	辛⺁厶辛
怆	忄人⺋󰁀
耆	土丿匕日
舴	丿󰁪𠂉二
铣	钅丿土儿
哏	口彐󰀖󰁶
郫	白丿十阝
诈	讠𠂉丨二
惫	夂田心󰁧
嘘	口󰅋七一
胫	月ス工󰀝
烫	氵ㄋ󰁤火
怖	忄冂丨
矗	十󰀣十󰀣
运	二厶辶󰀦
逖	犭ノ火辶
螵	虫覀二小
绶	纟爫冖又
缀	纟又又又
暇	日󰁃丨又
开	一廾󰀵
枵	木口一ㄅ
延	丿止廴󰀌
岭	山人丶󰁻
吣	口心󰁶
鲭	󰁢󰀞主月
葬	艹一夕廾
沭	氵木丶󰁶
喎	口ㄇ󰁈口
浏	氵文刂󰀢
怫	忄弓󰀯󰀢
笤	⺮刀口󰀘
岙	丿大山󰀬
缶	󰅎山󰀵
彀	士冖一又
伶	亻人丶󰁻
杵	木𠂉十󰀢
咬	口亠八乂
晗	日人丶口
董	艹丿一土
撬	扌丿二乚
噗	口󰅊一人
鳙	󰁢󰀞广丨
糙	米丿土辶
恫	忄冂一口
峙	山土寸󰁶
轶	车󰅎人󰁶
眵	目夕夕󰁶
朵	几木󰁧
佶	亻士口󰀝
召	刀口󰀘
备	夂田󰀘
庐	广丶尸󰀏
惆	忄󰀼土口
阎	门⺈臼󰀌
複	衤󰁧𠂉夂
洙	氵󰅎󰅇󰁶
跏	口止力口
嘎	口丆目戈
明	日月󰀝
躐	口止巛󰁒
厣	厂犬甲󰀵
锗	钅土丿日
室	宀一厶土
辶	辶丶󰁈󰂃
囵	囗人匕󰁫
澶	氵亠囗一
听	口斤󰀢
搬	扌丿󰁪又
琬	王宀夕⺋
语	讠五口󰀝
愆	彳氵一心
脆	月⺈厂⺋
踏	口止水日
此	止匕󰁀
锘	钅艹口
帏	冂丨二丨
绐	纟厶口󰀝
揣	扌山丆〢
口	口口口口
孤	孑⺁厶󰂃
枇	木󰁴匕󰁀
一	一一〇〇
敬	艹勹口夂
啬	十䒑囗口
娈	亠󰁗女󰀘
菘	艹木八厶
变	亠󰁗又󰁧
末	一木󰀦
玖	王ク󰂃󰁶
字	宀子󰀘
掖	扌亠亻丶
攻	工夂󰁶
挣	扌⺈󰁬亅
尴	乚〢皿
犏	ノ扌丶艹
谴	讠口丨辶
芏	艹土󰀘
睇	目丷弓丿
疬	疒厂力󰀏
均	土勹冫󰀝
蝇	虫口日乚
诙	讠火󰁶
睫	目一󰁬󰁾
掘	扌尸凵山
厘	厂日土󰀌
算	⺮目廾󰀬
卖	十乛󰁦大
捣	扌勹丶山
卣	󰀥囗󰁃󰀘
荣	艹冖木󰁧
詈	罒言󰀘
蕻	艹󰂞󰁺八
龀	止人凵ヒ
匏	大二ㄅ巳
往	彳丶王󰀝
粤	丿囗米ㄅ
谙	讠立日󰀝
鲤	󰁢󰀞日土
员	口贝󰁧
蓬	艹夂三辶
阗	门十󰀣八
咻	口亻木󰁶
馈	⺈󰁐口贝
鲴	󰁢󰀞囗古
榈	木门口口
劣	小丿力󰁣
翀	羽口丨󰀢
激	氵白方夂
萘	艹大二小
峭	山⺌月󰀝
甬	󰁻用󰀬
汤	氵ㄋ󰁤ノ
锬	钅火火󰁶
苣	艹匚󰁃󰀘
拣	扌󰀂𠃌八
籴	丿󰂃米󰁧
汴	氵亠卜󰁶
览	〢𠂉丶󰁜
纭	纟二厶󰁶
噬	口⺮工人
亭	󰁸冖丁󰀬
酴	西一人木
陬	阝耳又󰁶
虬	虫乚󰁀
拘	扌勹口󰀝
瘫	疒又亻󰁷
掏	扌勹󰅎山
勘	艹三八力
贤	〢又贝󰁧
咖	口力口󰀝
舣	丿󰁪丶乂
汗	氵干󰀢
鎏	氵亠厶金
钇	钅乙󰁀
蒇	艹厂贝丶
璇	王方𠂉󰁾
撇	扌丷冂夂
麽	广木木厶
醴	西一ㄇ䒑
蚬	虫ㄇ󰁜󰁀
鹭	口止夂一
癫	疒十󰀣贝
折	扌斤󰀢
噫	口立日心
浈	氵󰀥贝󰁶
虫	虫丨󰁈丶
岗	山冂乂󰁧
扣	扌口󰀝
荏	艹亻丿士
粗	米󰀐一󰀝
赀	止匕贝󰁧
摇	扌爫󰅎山
庀	广匕󰁫
眇	目小丿ノ
鸭	甲勹丶一
中	口丨󰀵
蜇	扌斤虫󰁧
渭	氵田月󰀝
郴	木木阝󰀢
胴	月冂一口
岈	山󰀂亅丿
涤	氵夂木󰁶
笙	⺮丿主󰀘
化	亻ヒ󰁀
挖	扌宀八乙
猖	犭ノ日日
鲈	󰁢󰀞󰀥尸
萏	艹⺈臼󰀘
琏	王车辶󰁶
醣	西一广口
鼽	丿目田九
膣	月宀八土
什	亻十󰀢
纽	纟󰁈丨二
溽	氵厂二寸
噼	口尸口辛
蛇	虫宀匕󰁀
雇	丶尸亻󰁷
嘬	口日耳又
嗫	口耳又又
描	扌艹田󰀝
痫	疒门木󰀦
歙	人一口人
闫	门三󰀌
赤	土󰁖󰁧
拖	扌𠂉也󰁀
嬗	女亠囗一
糈	米乛󰁾月
菏	艹氵丁口
隼	亻󰁷十󰀬
甫	一用丶
蔫	艹一止灬
浇	氵弋丿儿
疆	弓土一一
两	一冂人人
酢	西一𠂉二
忾	忄󰅎⺄󰁀
鬻	弓米弓丨
捺	扌大二小
喆	士口士口
瞽	士口䒑目
圳	土川󰀢
区	匚乂󰀦
祗	礻󰁶󰁚丶
碎	石亠人十
胍	月⺁厶󰂃
鹤	冖亻󰁷一
膘	月覀二小
熘	火󰁚丶田
淤	氵方人󰁦
肢	月十又󰁶
髻	󰂞彡士口
转	车二󰁓丶
绳	纟口日乚
睽	目癶一大
卺	了󰀩一⺋
馗	九䒑丿目
硎	石一廾刂
愍	󰁃󰁐弋心
脍	月人二厶
香	禾日󰀘
咫	尸󰂃口八
托	扌丿七󰁀
纤	纟丿十󰀢
郢	口王阝󰀢
寇	宀二儿又
鹾	󰀥囗乂工
篇	⺮丶尸艹
萆	艹白丿十
湾	氵亠󰁗弓
狺	犭ノ言󰀝
纳	纟冂人󰁶
蛲	虫弋丿儿
乾	十早𠂉乙
曲	ㄇ󰁺󰀌
佬	亻土丿匕
吖	口丷丨󰀢
毗	田󰁴匕󰁀
诗	讠土寸󰁶
椎	木亻󰁷󰀝
棣	木󰁬氺󰁶
聍	耳宀丁󰀢
遍	丶尸冂辶
橙	木癶一䒑
刘	文刂󰀢
揆	扌癶一大
谇	讠亠人十
簇	⺮方𠂉大
国	囗王丶󰀦
鹳	艹口口一
纾	纟󰁻乛亅
嘲	口十日月
侬	亻冖󰀔󰁶
取	耳又󰁶
揖	扌口耳󰀝
鏖	广󰁃〢金
勺	勹丶󰀦
悍	忄日干󰀢
傍	亻亠丷方
惢	心心心󰁧
碣	石日勹󰄃
风	几乂󰀦
裎	衤󰁧口王
伤	亻𠂉力ノ
墙	土十䒑口
灼	火勹丶󰁶
奏	三人一大
憎	忄丷󰀺日
漤	氵木木女
虺	一儿虫󰀦
鸳	夕⺋勹一
乳	爫孑乚󰁀
抖	扌󰁦十󰀢
穗	禾一日心
档	木⺌彐󰀝
顽	二儿丆贝
酎	西一寸󰁶
炼	火󰀂𠃌八
衽	衤󰁧丿士
跻	口止文󰀯
裙	衤󰁧󰁬口
磙	石六厶󰀔
煎	䒑月刂灬
跳	口止儿󰀪
疲	疒󰅌又󰀦
淳	氵󰁸子󰀝
骇	󰀊󰀞亠人
窗	宀八丿夕
智	𠂉大口日
剖	立口刂󰀢
主	丶王󰀌
恢	忄火󰁶
砣	石宀匕󰁀
糇	米亻ユ大
垣	土一日一
鳇	󰁢󰀞白王
玫	王夂󰁶
褙	衤󰁧丬月
戎	戈󰀏
足	口󰁾󰁧
闲	门木󰀦
佾	亻八月󰀝
罾	罒丷󰀺日
栽	十戈木󰀦
轾	车一厶土
巳	巳󰁈一乚
焖	火门心󰁶
脖	月十冖子
添	氵一大⺗
喺	口亻丿小
洇	氵囗大󰁶
铆	钅󰁚丿卩
蔺	艹门亻󰁷
焘	三丿寸灬
燎	火大丷小
脘	月宀二儿
甲	甲丨󰁈丨
锲	钅三丨大
赳	土󰁾󰁐丨
柽	木又土󰀝
矽	石夕󰁶
达	大辶󰀦
逼	一口田辶
嗲	口八乂夕
胖	月䒑十󰀢
旺	日王󰀝
鞣	廿󰀜󰁻木
僖	亻士口口
圣	又土󰀘
兼	䒑󰁬󰁗󰁧
蜣	虫䒑󰀠乚
罗	罒夕󰁧
筇	⺮工阝󰀬
笫	⺮丿ㄅ丿
荪	艹孑小󰁧
敲	󰁸冂口又
畲	人二小田
蕲	艹丷曰斤
魇	厂犬白厶
煺	火彐󰀖辶
乏	丿之󰁧
嚎	口󰁸冖󰀓
皎	白亠八乂
腺	月白水󰁶
鹏	月月勹一
柙	木甲󰀢
埙	土口贝󰁶
楽	白󰀪木󰁧
蝣	虫方𠂉子
督	上小又目
辗	车尸󰁺󰀖
钲	钅一止󰀝
宇	宀一󰀛󰀬
得	彳日一寸
侗	亻冂一口
荆	艹一廾刂
傺	亻󰁯二小
噎	口士冖䒑
亏	二ㄅ󰁫
邺	󰅊一阝󰀢
肺	月一冂丨
躏	口止艹󰁷
胼	月䒑廾󰀢
嚣	口口丆口
分	八刀󰁣
戆	立早夂心
鲳	󰁢󰀞日日
聘	耳由一ㄅ
椽	木彑󰀓󰁶
爆	火日󰁺氺
觇	󰀥口ㄇ󰁜
惺	忄日丿主
胺	月宀女󰀝
黏	禾人氺口
滏	氵八乂䒑
经	纟ス工󰀝
泳	氵丶𠃌󰀩
咲	口䒑大󰁶
栅	木󰀼󰀼一
倘	亻⺌冂口
蛙	虫土土󰀝
豳	山一󰀓󰀓
米	米丶丿󰂃
訇	勹言󰀌
类	米大󰁧
携	扌亻󰁷乃
式	弋工
伏	亻犬󰁶
雎	󰀐󰀞亻󰁷
蛎	虫厂一󰁡
盎	ㄇ大皿󰀘
漏	氵尸雨󰁶
哲	扌斤口󰀘
俚	亻日土󰀝
稗	禾白丿十
檫	木宀󰁯小
託	言丿七󰁀
袖	衤󰁧由󰀝
颖	匕禾丆贝
訫	言心󰁶
隙	阝小日小
谳	讠十冂犬
葺	艹口耳󰀘
尻	尸九󰁫
摺	扌羽白󰀝
瞎	目宀三口
吲	口弓丨󰀢
穫	禾艹亻又
曙	日罒土日
扼	扌厂⺋󰁀
会	人二厶󰁧
醪	西一羽彡
蝙	虫丶尸艹
硖	石一丷大
诳	讠犭ノ王
癣	疒󰁢󰀞羊
掺	扌厶大彡
寻	彐寸󰁧
读	讠十乛大
玺	⺈小王丶
耍	丆冂〢女
呲	口止匕󰁀
逍	⺌月辶󰀌
扪	扌门󰁀
罚	罒讠刂󰀬
怍	忄𠂉丨二
坎	土⺈人󰁶
自	丿目󰀌
讳	讠二𠃌丨
樽	木丷西寸
匆	勹󰁤丶󰀦
绗	纟彳一丁
茆	艹󰁚丿卩
疣	疒乚丶
仗	亻󰂃󰁶
珺	王󰁬丿口
玲	王人丶󰁻
亚	一󰅊一󰀌
秫	禾木丶󰁶
俏	亻⺌月󰀝
鼗	儿󰀪士又
槽	木一ㄇ日
秽	禾山夕󰁶
弗	弓󰀯󰀵
缗	纟󰁃󰁐日
茺	艹亠厶儿
众	人人人󰁧
痣	疒士心󰀦
嗣	口冂艹口
揲	扌廿󰄃木
珲	王冖车󰀢
滚	氵六厶󰀔
眙	目厶口󰀝
娴	女门木󰁶
咎	夂卜口󰀘
汏	氵大󰁶
璎	王贝贝女
蒎	艹氵⺁󰀕
钎	钅丿十󰀢
鹚	䒑ㄠㄠ一
疙	疒𠂉乙󰁫
褫	衤󰁧⺁几
喙	口彑󰀓󰁶
料	米󰁦十󰀢
鬼	白󰁜厶󰀦
责	主贝󰁧
镢	钅厂䒑人
覆	覀彳𠂉夂
郅	一厶土阝
情	忄主月󰀝
敢	󰁈耳夂󰁶
跎	口止宀匕
孳	䒑ㄠㄠ子
挲	氵小丿手
敖	主󰁡夂󰁶
啖	口火火󰁶
呎	口尸󰂃󰁶
沏	氵七刀ノ
邪	󰀂亅丿阝
士	士一丨一
蕖	艹氵匚木
泣	氵立󰀝
镍	钅丿目木
渎	氵十乛大
与	一ㄅ一󰀌
笳	⺮力口󰀘
箬	⺮艹口
砖	石二󰁓丶
蠖	虫艹亻又
阙	门䒑凵人
锎	钅门一廾
昙	日二厶󰁧
瘙	疒又丶虫
跚	口止󰀼一
讼	讠八厶󰁶
瓢	覀二小󰂃
过	寸辶󰀦
阍	门󰁚弋日
鲣	󰁢󰀞〢土
济	氵文󰀯󰀢
赎	贝十乛大
譬	尸口立言
狳	犭ノ人木
婴	贝贝女󰀘
孬	丆卜女子
穴	宀八󰁧
擎	艹勹口手
驴	󰀊󰀞丶尸
铙	钅弋丿儿
衫	衤󰁧彡ノ
硫	石亠厶󰀸
怪	忄又土󰀝
屣	尸彳止󰁾
傅	亻一月寸
蟆	虫艹日大
炅	日火󰁧
嗍	口䒑凵月
涎	氵丿止廴
痍	疒一弓人
刳	大二ㄅ刂
戳	羽亻󰁷戈
谬	讠羽人彡
暖	日爫一又
皖	白宀二儿
聪	耳丷口心
钙	钅一󰀥ㄅ
绵	纟白冂丨
蜴	虫日勹󰁤
刻	亠ㄥ丿刂
朴	木卜󰁶
仵	亻𠂉十󰀢
呢	口尸匕󰁀
哙	口人二厶
鹇	门木勹一
皆	󰁴匕白󰀘
蹇	宀󰀀八󰁾
嚆	口艹󰁸口
乇	丿七󰁫
扳	扌⺁又󰁶
诬	讠工人人
癖	疒尸口辛
晖	日冖车󰀢
店	广󰀥口󰀌
矫	𠂉大丿󰀯
教	土丿孑夂
韫	二𠃌丨皿
缵	纟丿土贝
诣	讠匕日󰀝
围	囗二𠃌丨
探	扌冖八木
厢	厂木目󰀌
篼	⺮白󰁚儿
诼	讠一󰀓丶
咙	口ヒ丶
麇	广󰁃〢禾
躇	口止艹日
庇	广󰁴匕󰁫
导	巳寸󰁧
决	冫ユ人󰁶
泗	氵四󰀝
膳	月丷󰅆口
熳	火曰罒又
枫	木几乂󰁶
轵	车口八󰁶
螫	土󰁖夂虫
错	钅󰁺日󰀝
糗	米丿目犬
讣	讠卜󰁶
锖	钅主月󰀝
潵	氵󰁺月攵
沼	氵刀口󰀝
充	亠厶儿󰀅
煅	火亻三又
岚	山几乂󰁧
鲼	󰁢󰀞十贝
粼	米夕󰀂巜
凳	癶一口几
洗	氵丿土儿
至	一厶土󰀘
迤	𠂉也辶󰁫
猪	犭ノ土日
蝴	虫古月󰀝
靴	廿󰀜亻ヒ
侵	亻彐冖又
季	禾子󰀘
猢	犭ノ古月
内	冂人󰀦
醅	西一立口
裆	衤󰁧⺌彐
鱼	󰁢一󰀘
籼	米山󰀢
芎	艹弓󰀅
銎	工几丶金
贬	贝丿之󰁶
鬣	󰂞彡巛󰁒
卢	󰀥尸󰁣
欣	斤⺈人󰁶
缫	纟巛日木
洼	氵土土󰀝
坪	土一丷十
杪	木小丿ノ
伫	亻宀一󰀝
潇	氵艹󰁬󰀯
厕	厂贝刂󰀵
竖	〢又立󰀘
町	田丁󰀢
贼	贝戈ノ
钺	钅一󰁐丶
蒺	艹疒𠂉大
关	䒑大󰁧
煳	火古月󰀝
竣	立厶八夂
抢	扌人⺋󰁀
葙	艹木目󰀘
绫	纟土八夂
泼	氵ㄥ丿丶
仫	亻丿厶󰁶
殚	一夕丷十
呙	口冂人󰁧
单	丷曰十󰀬
杆	木干󰀢
徇	彳勹日󰀝
活	氵丿古󰀝
龇	止人凵匕
辇	二人二车
茎	艹ス工󰀘
鲻	󰁢󰀞巛田
挎	扌大二ㄅ
猎	犭ノ󰁺日
跗	口止亻寸
阖	门土厶皿
炳	火一冂人
纫	纟刀丶󰁶
身	丿󰀽三丿
雪	󰀙彐󰀘
嫣	女一止灬
享	󰁸子󰀘
吕	口口󰀘
趼	口止一廾
峻	山厶八夂
系	丿ㄠ小󰁧
泻	氵冖一一
鬏	󰂞彡禾火
苎	艹宀一󰀘
笏	⺮勹󰁤󰁣
拎	扌人丶󰁻
嗖	口臼丨又
痖	疒一󰅊一
渗	氵厶大彡
戢	口耳󰅅丶
胳	月夂口󰀝
舢	丿󰁪山󰀢
想	木目心󰁧
僳	亻覀米󰁶
狙	犭ノ󰀐一
拙	扌凵山󰀢
浼	氵⺈口󰁜
鹫	󰁸小一
岖	山匚乂󰁶
万	一󰁡󰀏
哺	口一月丶
治	氵厶口󰀝
礴	石艹氵寸
耻	耳止󰀝
钆	钅乚󰁀
掎	扌大丁口
豇	一口䒑工
咆	口勹巳󰁀
黾	口日乚󰀅
耳	耳一丨一
鸬	󰀥尸勹一
廾	廾一丿丨
玎	王丁󰀢
莎	艹氵小丿
魏	禾女白厶
渫	氵廿󰄃木
筚	⺮󰁴匕十
丫	丷丨󰀵
噪	口口口木
帼	冂丨囗丶
芙	艹二人󰁧
陪	阝立口󰀝
饴	⺈󰁐厶口
裴	三〢三󰀔
磴	石癶一䒑
捎	扌⺌月󰀝
宏	宀厶󰁧
葆	艹亻口木
醢	西一皿
摆	扌罒土厶
秣	禾一木󰁶
跬	口止土土
虽	口虫󰁧
漾	氵丷王󰀩
淬	氵亠人十
媚	女󰁅目󰀝
淫	氵爫丿士
骚	󰀊󰀞又虫
薪	艹立木斤
淼	水水水󰁧
逻	罒夕辶󰀦
后	⺁一口󰀌
榴	木󰁚丶田
纬	纟二𠃌丨
京	󰁸小󰁧
躬	丿󰀽三弓
萎	艹禾女󰀘
嗪	口三人禾
涫	氵
痪	疒⺈ㄇ大
闪	门人󰀦
茕	艹冖⺄十
圆	囗口贝󰀦
滇	氵十󰀣八
织	纟口八󰁶
霆	󰀙丿士廴
揎	扌宀一一
小	小亅丿丶
饣	⺈󰁐󰀅
饫	⺈󰁐丿大
渚	氵土丿日
蹬	口止癶䒑
妣	女󰁴匕󰁀
苕	艹刀口󰀘
缇	纟日一󰁾
殖	一夕十󰀣
集	亻󰁷木󰁧
蛆	虫󰀐一󰀝
氲	󰅎⺄日皿
株	木󰅎󰅇󰁶
鳆	󰁢󰀞𠂉夂
醍	西一日󰁾
觎	人一月󰁜
槎	木䒑󰀠工
再	一冂土󰀌
镪	钅弓口虫
冕	曰⺈口󰁜
紫	止匕ㄠ小
贫	八刀贝󰁧
啪	口扌白󰀝
洫	氵丿皿󰀝
凹	丨󰁎󰀽一
吱	口十又󰁶
故	古夂󰁶
畅	日丨ㄋ󰁤
配	西一己󰁀
镅	钅󰁅目󰀝
税	禾丷口儿
免	⺈口󰁜󰀅
萱	艹宀一一
腕	月宀夕⺋
亻	亻丿丨
固	囗古󰀌
溻	氵日羽󰀝
钪	钅亠几󰁀
外	夕卜󰁶
慕	艹日大⺗
泫	氵亠ㄠ󰁶
咪	口米󰁶
覚	󰀧冖目儿
禚	礻󰁶丷灬
沲	氵𠂉也󰁀
酩	西一夕口
腩	月十冂十
穆	禾白小彡
戍	厂丶󰅅丶
鲲	󰁢󰀞日匕
舍	人干口󰀘
粲	󰀥夕又米
戕	󰄃丨丆戈
任	亻丿士󰀝
铪	钅人一口
黻	󰅊一丷丶
蚺	虫冂土󰀝
则	贝刂󰀢
沫	氵一木󰁶
觚	⺈用⺁󰂃
疱	疒勹巳󰁫
饪	⺈󰁐丿士
骆	󰀊󰀞夂口
肩	丶尸月󰀌
窆	宀八丿之
重	丿一日土
喱	口厂日土
窖	宀八丿口
鼻	丿目田󰀯
骖	󰀊󰀞厶彡
多	夕夕󰁧
婆	氵󰅌又女
胙	月𠂉丨二
烙	火夂口󰀝
搪	扌广󰁬口
痱	疒丨三三
洲	氵丶丿丨
闱	门二𠃌丨
贲	十艹贝󰁧
褪	衤󰁧彐辶
烩	火人二厶
惩	彳一止心
太	大丶󰀦
钅	钅丿一󰁐
撅	扌厂䒑人
密	宀心丿山
识	讠口八󰁶
篆	⺮彑󰀓󰁧
碍	石日一寸
佻	亻儿󰀪󰁶
偌	亻艹口
轻	车ス工󰀝
颍	匕水丆贝
袍	衤󰁧勹巳
奚	爫ㄠ大󰁧
咕	口古󰀝
谫	讠䒑月刀
邙	亠󰄃阝󰀢
楚	木木乛󰁾
炙	󰁝火󰁧
锱	钅巛田󰀝
由	由丨󰁈一
将	丬夕寸󰁶
唱	口日日󰀝
谆	讠󰁸子󰀝
悌	忄丷弓丿
瀹	氵人一艹
塍	月䒑大土
肌	月几󰁀
瞢	艹罒冖目
墚	土氵刀木
瘩	疒艹人口
蘩	艹𠂉母小
簖	⺮米󰄃斤
颚	口口二贝
腙	月宀二小
镱	钅立日心
液	氵亠亻丶
锅	钅口冂人
赆	贝尸󰂃󰁦
浆	丬夕水󰁧
啱	口山石󰀝
复	𠂉日夂󰁧
忻	忄斤󰀢
螺	虫田ㄠ小
祖	礻󰁶󰀐一
愕	忄口口ㄅ
背	丬匕月󰀘
噩	王口口口
辣	立一󰅇
宫	宀口口󰀘
揪	扌禾火󰁶
焙	火立口󰀝
菪	艹宀石󰀘
鄙	口十囗阝
干	干一一丨
桢	木󰀥贝󰁶
蹲	口止丷寸
股	月几又󰁶
邡	方阝󰀢
擅	扌亠囗一
顺	川丆贝󰁶
首	䒑丿目󰀘
霪	󰀙氵爫士
棍	木日󰁴匕
珙	王󰁺八󰁶
妖	女丿大󰁶
圪	土𠂉乙󰁀
斩	车斤󰀢
蜢	虫子皿󰀝
眢	夕⺋目󰀘
佣	亻用󰀢
鹪	亻󰁷灬一
鸲	勹口勹一
菹	艹氵󰀐一
横	木󰁺由八
蛱	虫一丷大
尺	尸󰂃󰀦
郡	󰁬丿口阝
蠢	三人日虫
串	口口丨󰀵
枕	木冖󰁜󰁀
廖	广羽人彡
鞍	廿󰀜宀女
融	一口冂虫
翎	人丶󰁻羽
面	丆冂〢三
俎	人人󰀐一
睢	目亻󰁷󰀝
担	扌日一󰀝
阱	阝二󰀯󰀢
绲	纟日󰁴匕
嘱	口尸丿丶
倡	亻日日󰀝
仲	亻口丨󰀢
裢	衤󰁧车辶
逡	厶八夂辶
猩	犭ノ日主
编	纟丶尸艹
他	亻也󰁀
坍	土󰀼亠󰀝
代	亻
棺	木宀丨󰁃
磺	石󰁺由八
厅	厂丁󰀵
鄹	耳又乑阝
绣	纟禾乃ノ
柄	木一冂人
媪	女日皿󰀝
躲	丿󰀽三木
梢	木⺌月󰀝
溲	氵
噱	口󰅋七󰀓
亲	立木󰁧
蠕	虫󰀙丆〢
颢	曰󰁸小贝
袢	衤󰁧䒑十
荩	艹尸󰂃󰁦
砍	石⺈人󰁶
低	亻󰁚󰀁丶
堍	土⺈口丶
兹	䒑ㄠㄠ󰁧
团	囗󰀛丿󰀏
酹	西一爫寸
腹	月𠂉日夂
捅	扌󰁻用
笆	⺮巴󰀅
孪	亠󰁗子󰀘
歪	丆卜一止
奢	大土丿日
耔	三󰅇子󰀝
途	人一木辶
怔	忄一止󰀝
祢	礻󰁶⺈小
芩	艹人丶乛
美	丷王大󰁧
而	丆冂〢󰀬
堕	阝月土
倌	亻宀丨󰁃
澎	氵士口彡
点	󰀥口灬󰁧
漳	氵立早󰀢
缳	纟罒一󰀔
瘢	疒丿󰁪又
阢	阝一儿󰁀
邹	⺈彐阝󰀢
择	扌又二丨
凡	几丶󰀦
视	礻󰁶ㄇ󰁜
秆	禾干󰀢
笪	⺮日一󰀘
投	扌几又󰁶
觖	⺈用ユ人
示	二小󰁧
从	人人󰁶
夺	大寸󰁧
朲	木人󰁶
黎	禾勹丿氺
蚍	虫󰁴匕󰁀
踣	口止立口
院	阝宀二儿
儡	亻田田田
蟪	虫一日心
韪	日一󰁾丨
稆	禾口口󰀝
倩	亻主月󰀝
関	門䒑大󰀦
跣	口止丿儿
伎	亻十又󰁶
噍	口亻󰁷灬
姆	女母󰁶
虍	󰅋七󰁫
鼎	目󰁕丆󰁈
刹	乂木刂󰀢
癍	疒王文王
瞪	目癶一䒑
枪	木人⺋󰁀
聩	耳口丨贝
蜕	虫丷口儿
酡	西一宀匕
朕	月䒑大󰁶
彖	彑󰀓󰁧
痢	疒禾刂󰀵
趣	土󰁾耳又
涣	氵⺈ㄇ大
翳	匚𠂉大羽
禺	日冂丨丶
垲	土山己󰁀
乎	丿丷󰀛󰀵
眍	目匚乂󰁶
服	月卩又󰁶
鹎	白丿十一
迳	ス工辶󰀌
抡	扌人匕󰁀
芡	艹⺈人󰁧
硪	石丿扌丶
雕	󰀼土口󰁷
辖	车宀三口
婢	女白丿十
赣	立早夂贝
锢	钅囗古󰀝
浣	氵宀二儿
锪	钅勹󰁤心
赫	土󰁖土󰁖
稚	禾亻󰁷󰀝
空	宀八工󰀘
囍	士口䒑口
婺	󰁻乛亅女
盍	土厶皿󰀘
包	勹巳󰁫
雍	亠󰁲丿󰁷
狡	犭ノ亠乂
界	田人󰀯󰀬
敌	丿古夂󰁶
苡	艹󰁐丶人
糖	米广󰁬口
卸	󰅎止卩󰀢
欹	大丁口人
圻	土斤󰀢
荸	艹十冖子
蜻	虫主月󰀝
响	口丿冂口
操	扌口口木
舡	丿󰁪工󰀝
戡	艹三八戈
淹	氵大日乚
跹	口止丿辶
疸	疒日一󰀌
泖	氵󰁚丿卩
劲	ス工力ノ
熄	火丿目心
镌	钅亻󰁷乃
旌	方𠂉丿主
嗌	口䒑八皿
阕	门癶一大
不	丆卜󰀦
剡	火火刂󰀢
鹆	八人口一
蘅	艹彳󰁢丁
瘅	疒丷曰十
狲	犭ノ孑小
崖	山厂土土
狸	犭ノ日土
阌	门爫冖又
赍	十人人贝
藕	艹三󰅇丶
浍	氵人二厶
孢	孑勹巳󰁀
止	止丨一一
筢	⺮扌巴󰀅
驻	󰀊󰀞丶王
病	疒一冂人
维	纟亻󰁷󰀝
嗅	口丿目犬
旅	方𠂉󰀕󰁶
了	了乛亅
筹	⺮三丿寸
歹	一夕󰀦
茸	艹耳󰀘
瘕	疒󰁃丨又
湖	氵古月󰀝
乖	丿十丬匕
钍	钅土󰀝
握	扌尸一土
叡	󰀥冖一又
菡	艹了󰀪凵
联	耳䒑大󰁶
缴	纟白方夂
艺	艹乙󰀅
颅	󰀥尸丆贝
伴	亻䒑十󰀢
割	宀三丨刂
忆	忄乙󰁀
稳	禾⺈彐心
色	⺈巴󰀅
尹	󰁬丿󰀏
摸	扌艹日大
葸	艹田心󰁧
锈	钅禾乃ノ
庖	广勹巳󰁫
篪	⺮⺁󰅋几
猡	犭ノ罒夕
利	禾刂󰀢
匡	匚王󰀌
挡	扌⺌彐󰀝
桕	木臼󰀝
硕	石丆贝󰁶
珑	王ヒ丶
崤	山乂月
妪	女匚乂󰁶
腴	月臼人󰁶
璺	󰀗ㄇ一丶
妈	女󰀊一󰀝
轴	车由󰀝
罴	罒土厶灬
否	丆卜口󰀘
醺	西一丿灬
佴	亻耳󰀝
聚	耳又乑󰁧
潴	氵犭ノ日
姻	女囗大󰁶
冲	冫口丨󰀢
芸	艹二厶󰁧
硅	石土土󰀝
衅	丿皿䒑十
豪	󰁸冖豕󰁧
觳	士冖一又
奶	女乃ノ
骞	宀󰀀八一
锍	钅亠厶󰀸
岌	山乃󰂃󰁧
簏	⺮广󰁃匕
鹬	󰁻乛亅一
订	讠丁󰀢
箢	⺮宀夕⺋
赖	一口󰅇贝
卡	上卜󰁧
垄	ヒ丶土
跟	口止彐󰀖
豹	豸勹丶󰁶
邋	巛囗乂辶
拗	扌ㄠ力ノ
沩	氵丶丿丶
锤	钅ノ一士
伛	亻匚乂󰁶
离	文凵冂厶
苏	艹力八󰁧
绾	纟宀丨󰁃
叟	臼丨又󰁧
跫	工几丶󰁾
庭	广丿士廴
妻	一󰁬丨女
榻	木日羽󰀝
幺	ㄠㄠㄠㄠ
妳	女⺈小󰁶
焚	木木火󰁧
毒	主母󰁧
洎	氵丿目󰀝
讹	讠亻ヒ󰁀
容	宀八人口
崎	山大丁口
蓍	艹土丿日
鲎	󰀧冖󰁢一
蓠	艹文凵厶
诲	讠𠂉母󰁶
憩	丿古丿心
颊	一丷大贝
陆	阝二山󰀢
婪	木木女󰀘
姣	女亠八乂
舛	夕󰀂丨󰀢
另	口力󰁣
铰	钅亠八乂
摩	广木木手
牺	ノ扌西󰀝
镀	钅广廿又
淆	氵乂月
塄	土罒方ノ
聋	ヒ丶耳
戤	乃又皿戈
樨	木尸氺丨
琢	王一󰀓丶
娜	女刀二阝
岱	亻󰀁丶山
襻	衤󰁧木手
砻	ヒ丶石
壅	亠󰁲丿土
女	女女女女
醚	西一米辶
装	丬士亠󰀔
鄄	覀土阝󰀢
萸	艹臼人󰁧
籹	米女󰀝
弑	乂木󰀁丶
宕	宀石󰀘
荔	艹力力力
箕	⺮艹三八
骘	阝止󰀤一
凸	丨一丨一
诎	讠凵山󰀢
知	𠂉大口󰀝
铎	钅又二丨
鳓	󰁢󰀞廿力
每	𠂉母󰁧
瓿	立口一丶
甓	尸口立丶
啸	口󰁬󰅏󰀯
洹	氵一日一
畸	田大丁口
费	弓󰀯贝󰁧
仆	亻卜󰁶
细	纟田󰀝
怵	忄木丶󰁶
鞅	廿󰀜ㄇ大
螅	虫丿目心
幼	ㄠ力ノ
肪	月方ノ
尢	乚󰁫
矶	石几󰁀
疫	疒几又󰀦
兲	王八󰁧
铡	钅贝刂󰀢
谢	讠丿󰀽寸
殓	一夕人一
酲	西一口王
蕾	艹󰀙田󰀘
茔	艹冖土󰀘
啡	口丨三三
啕	口勹󰅎山
牝	ノ扌匕
诱	讠禾乃ノ
獍	犭ノ立儿
谎	讠艹亠󰀸
哿	力口丁口
瑗	王爫一又
篱	⺮文凵厶
跺	口止几木
嚏	口十冖󰁾
葫	艹古月󰀘
笼	⺮ヒ丶
既	彐厶󰀂󰁜
谪	讠亠丷古
纛	主母󰀣小
育	亠厶月󰀘
缆	纟〢𠂉󰁜
悲	三〢三心
傲	亻主󰁡夂
解	⺈用刀丨
坊	土方ノ
搡	扌又又木
厍	厂车󰀵
豸	豸丿丶丿
吡	口󰁴匕󰁀
躯	丿󰀽三乂
殳	几又󰁧
勖	曰目力ノ
鳢	󰁢󰀞ㄇ䒑
叔	上小又󰁶
蠊	虫广䒑󰁗
莨	艹丶彐󰀖
筋	⺮月力󰁣
萍	艹氵一十
谕	讠人一刂
甑	丷󰀺日丶
氕	󰅎⺄丿󰁣
烁	火丿󰄃小
兜	白󰁚󰁃儿
栊	木ヒ丶
啻	亠丷冖口
豆	一口䒑󰀘
粹	米亠人十
搅	扌󰀧冖󰁜
抚	扌二󰁜󰁀
死	一夕匕󰁫
呦	口ㄠ力ノ
碳	石山火
铸	钅三丿寸
底	广󰁚󰀁丶
梳	木亠厶󰀸
槌	木亻󰁃辶
臁	月广䒑󰁗
粢	冫⺈人米
捍	扌日干󰀢
岢	山丁口󰀘
慵	忄广󰁬丨
瓴	人丶󰁻丶
溅	氵贝二丶
鲢	󰁢󰀞车辶
葡	艹勹一丶
孕	乃子󰀘
筏	⺮亻戈󰁧
哦	口丿扌丶
舂	三人臼󰀘
珍	王人彡ノ
牢	宀󰅎丨
瓷	冫⺈人丶
筲	⺮⺌月󰀘
莱	艹一米󰁧
隽	亻󰁷乃󰁣
鲆	󰁢󰀞一十
茅	艹󰁻乛丿
唸	口人丶心
菅	艹宀丨󰁃
甸	勹田󰀌
攸	亻丨夂󰁶
锸	钅丿十臼
蔸	艹白󰁚儿
踢	口止日󰁤
酌	西一勹丶
嫡	女亠丷古
骜	主󰁡夂一
望	亠󰁐月王
须	彡丆贝󰁶
疡	疒ㄋ󰁤󰀏
赢	亠󰄃口丶
刈	乂刂󰀢
名	夕口󰀘
孝	土丿子󰀘
芰	艹十又󰁧
跤	口止亠乂
斡	十早人十
罘	罒丆卜󰁧
跖	口止石󰀝
骥	󰀊󰀞丬八
毪	丿二乚丨
叱	口ヒ󰁀
击	二山󰀵
子	子子子子
欲	八人口人
鬲	一口冂丨
丹	󰀼亠󰀌
犍	ノ扌󰁬廴
甍	艹罒冖丶
痂	疒力口󰀌
嵊	山禾丬匕
膪	月亠丷口
俳	亻丨三三
跆	口止厶口
阀	门亻戈󰀦
軎	車口󰀘
隅	阝日冂丶
癸	癶一大󰁧
踹	口止山〢
鸹	丿古勹一
嚅	口󰀙丆〢
财	贝󰀛丿ノ
索	十冖ㄠ小
搴	宀󰀀八手
恺	忄山己󰁀
罅	󰅎山󰅋󰀛
痕	疒彐󰀖󰀦
账	贝丿七󰂃
嗡	口八厶羽
繁	𠂉母夂小
陕	阝一丷大
艘	丿󰁪臼又
魔	广木木厶
慷	忄广󰁬氺
猱	犭ノ󰁻木
汾	氵八刀ノ
嫘	女田ㄠ小
漓	氵文凵厶
迓	󰀂亅丿辶
才	󰀛丿󰀏
牍	丿丨一大
杩	木󰀊一󰀝
撸	扌󰁢一日
咸	厂一口丶
悔	忄𠂉母󰁶
石	石一丿一
柳	木󰁚丿卩
际	阝二小󰁶
蒸	艹了󰀩灬
実	宀三人󰁧
豢	䒑大一󰀓
音	立日󰀘
哎	口艹乂󰁶
锡	钅日勹󰁤
航	丿󰁪亠几
侃	亻口󰀸󰁀
蔡	艹󰁯二小
巢	巛日木󰁧
蓦	艹日大一
劢	一󰁡力ノ
淖	氵󰀥早󰀢
苔	艹厶口󰀘
笕	⺮ㄇ󰁜󰀅
拔	扌又丶
膺	广亻亻月
瓦	一󰁐󰁊丶
捱	扌厂土土
危	⺈厂⺋󰀅
诚	讠厂𠃌丶
篚	⺮匚丨三
秀	禾乃󰁣
援	扌爫一又
讲	讠二󰀯󰀢
渡	氵广廿又
庾	广臼人󰀦
拢	扌ヒ丶
骣	󰀊󰀞尸子
枳	木口八󰁶
瞳	目立日土
邳	丆卜󰀞阝
但	亻日一󰀝
闸	门甲󰀵
前	䒑月刂󰀬
螳	虫⺌冖土
荇	艹彳一丁
磬	士󰁅几石
镡	钅覀早󰀢
瞻	目⺈厂言
官	宀丨󰁃󰁃
世	廿󰄃󰁫
帖	冂丨󰀥口
渖	氵宀曰丨
煲	亻口木火
冀	丬匕田八
哽	口一日乂
咱	口丿目󰀝
汲	氵乃󰂃󰁶
娶	耳又女󰀘
讴	讠匚乂󰁶
叛	丷󰀠⺁又
廪	广亠囗小
拍	扌白󰀝
狍	犭ノ勹巳
苍	艹人⺋󰀅
脲	月尸水󰁶
蟊	󰁻乛亅虫
扭	扌󰁈丨二
钱	钅戋
瞍	目臼丨又
坳	土ㄠ力ノ
盅	口丨皿󰀘
律	彳󰁬二丨
杳	木日󰀘
靳	廿󰀜斤󰀢
瘸	疒力口人
辆	车一冂人
雅	󰀂亅丿󰁷
坻	土󰁚七丶
蜚	三〢三虫
斐	三〢三文
骠	󰀊󰀞覀小
呖	口厂力ノ
蝻	虫十冂十
镓	钅宀一󰀓
碴	石木日一
寅	宀一由八
瑙	王巛丿乂
鞲	廿口十土
夹	一丷大󰀦
坑	土亠几󰁀
廨	广⺈月󰀟
廉	广䒑󰁬󰁗
谛	讠亠丷丨
腔	月宀八工
瞀	󰁻乛亅目
闯	门󰀊一󰀌
馕	⺈󰁐一󰀔
树	木又寸󰁶
泺	氵丿󰄃小
榕	木宀八口
兔	⺈口󰁜丶
蝠	虫一口田
涅	氵日土󰀝
镄	钅弓󰀯贝
馍	⺈󰁐艹大
腌	月大日乚
煌	火白王󰀝
榍	木尸⺌月
妍	女一廾󰀢
弼	弓丆日弓
更	一日乂󰀦
麂	广󰁃〢几
骏	󰀊󰀞厶夂
天	一大󰀦
慨	忄彐厶󰁜
煨	火田一󰀖
似	亻󰁐丶人
麒	广󰁃〢八
溷	氵囗一󰀓
险	阝人一一
驰	󰀊󰀞也󰁀
切	七刀ノ
塘	土广󰁬口
统	纟亠厶儿
靡	广木木三
飕	几乂臼又
衢	彳目目丁
磕	石土厶皿
脔	亠󰁗冂人
壕	土󰁸冖󰀓
棕	木宀二小
藐	艹豸白儿
胁	月力八󰁶
觏	󰀀ㄇ土󰁜
鳅	󰁢󰀞禾火
泅	氵囗人󰁶
糅	米󰁻乛木
狭	犭ノ一大
黢	󰀹土灬夂
滢	氵艹冖丶
绢	纟口月󰀝
韩	十日十丨
佼	亻
矩	𠂉大匚󰁃
柩	木匚ク丶
扰	扌乚丶
轼	车󰀁工丶
榉	木󰀧一󰀟
潼	氵立日土
别	口力刂󰀢
捌	扌口力刂
衍	彳氵一丁
彪	󰅋七几彡
数	米女夂󰁶
韬	二𠃌丨臼
佤	亻一󰁐丶
嗰	口亻囗古
燔	火丿米田
懔	忄亠囗小
疯	疒几乂󰀦
羁	罒廿口一
功	工力ノ
沥	氵厂力ノ
杉	木彡ノ
辔	车纟纟口
蕺	艹口耳丶
里	日土󰀌
犟	弓口虫󰀟
芟	艹几又󰁧
陡	阝土󰁾󰁶
凌	冫土八夂
臌	月士口又
稍	禾⺌月󰀝
旰	日干󰀢
痰	疒火火󰀦
趱	土󰁾丿贝
闰	门王󰀌
烨	火亻ヒ十
胨	月󰀂小󰁶
墩	土󰁸孑攵
惨	忄厶大彡
机	木几󰁀
貅	豸亻木󰁶
坶	土母󰁶
恨	忄彐󰀖󰁶
肄	匕𠂉大󰀟
魃	白󰁜厶丶
鳘	𠂉母夂一
纷	纟八刀ノ
熔	火宀八口
山	山山山山
饕	口一ㄅ󰀖
琶	王王巴󰀅
奎	大土土󰀘
缡	纟文凵厶
奕	亠󰁖大󰁧
憔	忄亻󰁷灬
垡	亻戈土󰀘
潢	氵󰁺由八
赅	贝亠ㄥ人
建	󰁬󰀟廴󰀵
堡	亻口木土
肓	亠󰄃月󰀘
册	󰀼󰀼一󰀌
佢	亻匚󰁃󰀝
舨	丿󰁪⺁又
饩	⺈󰁐󰅎⺄
闶	门亠几󰁫
铖	钅厂𠃌丶
翼	羽田󰁺八
睡	目ノ一士
妞	女󰁈丨二
善	丷󰅆䒑口
伙	亻火󰁶
器	口口大口
晨	日厂二󰀖
雳	󰀙厂力󰁣
踩	口止爫木
鸩	冖󰁜勹一
鲕	󰁢󰀞丆〢
裳	⺌冖口󰀔
硌	石夂口󰀝
桌	󰀥日木󰁧
塌	土日羽󰀝
遘	󰀀冂土辶
豺	豸󰀛丿ノ
鼢	臼󰁐󰁦刀
蘼	艹广木三
行	彳一丁󰀢
帝	亠丷冖丨
鲅	󰁢󰀞丶
楞	木罒方ノ
缢	纟䒑八皿
摄	扌耳又又
裣	衤󰁧人一
伢	亻󰀂亅丿
戋	二󰅅丶󰀦
贱	贝戋󰁥
镰	钅广䒑󰁗
洱	氵耳󰀝
脊	󰀪人月󰀘
垂	ノ一艹士
蓖	艹丿囗匕
轷	车丿丷󰀛
绊	纟䒑十󰀢
貘	豸艹日大
吔	口也󰁀
廊	广丶彐阝
怀	忄丆卜󰁶
试	讠弋工
庞	广ヒ丶
毕	󰁴匕十󰀬
轫	车刀丶󰁶
砌	石七刀ノ
驿	󰀊󰀞又󰀟
辈	三〢三车
夔	䒑丿目夂
叽	口几󰁀
垴	土文凵
忍	刀丶心󰁧
栌	木󰀥尸ノ
蟑	虫立早󰀢
蜡	虫󰁺日󰀝
予	󰁻乛亅󰀬
少	小丿󰀏
着	䒑󰀠目󰀘
诅	讠󰀐一󰀝
各	夂口󰀘
毅	立󰀓几又
疰	疒丶王󰀌
深	氵冖八木
甙	弋艹二丶
薰	艹丿一灬
麈	广󰁃〢王
兕	丨󰁎󰀽儿
您	亻⺈小心
储	亻讠土日
旨	匕日󰀘
痨	疒艹冖力
甄	覀土一丶
嗨	口氵𠂉母
钚	钅丆卜󰁶
邀	白方夂辶
唬	口󰅋七几
门	门丶丨𠃌
因	囗大󰀦
莠	艹禾乃󰁣
坚	〢又土󰀘
惹	艹口心
橘	木󰁻乛口
夕	夕丿乛丶
惠	一日丨心
碡	石主母󰁶
铄	钅丿󰄃小
颡	又又又贝
条	夂木󰁧
坡	土󰅌又󰁶
迫	白辶󰀌
泮	氵䒑十󰀢
逑	一氺丶辶
驳	󰀊󰀞乂乂
啄	口一󰀓丶
楗	木󰁬󰀟廴
庋	广十又󰀦
哚	口几木󰁶
哄	口󰁺八󰁶
溱	氵三人禾
纱	纟小丿ノ
蛰	扌九丶虫
慌	忄艹亠󰀸
乩	󰀥口乚󰁀
玢	王八刀ノ
昨	日𠂉丨二
鹩	大丷日一
蹩	丷冂󰅇󰁾
豕	一󰀓󰀦
钔	钅门󰁀
沔	氵一丨𠃌
碌	石󰁭氺󰁶
沛	氵一冂丨
露	󰀙口止口
暨	彐厶󰀂一
逃	儿󰀪辶󰀦
岸	山厂干󰀬
颌	人一口贝
旒	方𠂉亠󰀸
弥	弓⺈小󰁶
墀	土尸氺󰀟
驯	󰀊󰀞川󰀢
咄	口凵山󰀢
撄	扌贝贝女
鼷	臼󰁐󰁦大
庥	广亻木󰀦
锰	钅子皿󰀝
兴	󰀧一八󰁧
田	田田田田
荦	艹冖󰅎丨
预	󰁻乛亅贝
鲜	󰁢󰀞丷󰅆
赇	贝一氺丶
洋	氵丷󰅆󰀢
蹦	口止山月
摭	扌广廿灬
势	扌九丶力
倪	亻臼儿󰁀
衔	彳钅一丁
辙	车亠厶夂
像	亻⺈口󰀓
铭	钅夕口󰀝
衡	彳󰁢大丁
萨	艹阝立丿
辍	车又又又
蓰	艹彳止󰁾
杌	木一儿󰁀
坌	八刀土󰀘
侍	亻土寸󰁶
徜	彳⺌冂口
镭	钅󰀙田󰀝
骧	󰀊󰀞亠󰀔
蠡	彑󰀓虫虫
爻	乂乂󰁧
宅	宀丿七󰀅
荨	艹彐寸󰁧
辕	车土口󰀔
啦	口扌立󰀝
蒙	艹冖二󰀓
商	亠丷冂口
鸱	󰁚七丶一
啤	口白丿十
褰	宀󰀀八󰀔
踱	口止广又
帱	冂丨三寸
晰	日木斤󰀢
毓	𠂉母亠󰀸
篝	⺮󰀀冂土
仍	亻乃ノ
喘	口山丆〢
扔	扌乃ノ
绍	纟刀口󰀝
瘐	疒臼人󰀦
黍	禾人氺󰁧
迄	𠂉乙辶󰁫
判	丷󰀠刂󰀢
康	广󰁬氺󰀦
忄	忄丶丨丶
熨	尸二小火
憨	乛耳夂心
愚	日冂丨心
悠	亻丨夂心
橡	木⺈口󰀓
远	二儿辶󰁫
骑	󰀊󰀞大口
膨	月士口彡
绕	纟弋丿儿
拐	扌口力ノ
攀	木乂乂手
朔	䒑凵丿月
及	乃󰂃󰀦
隰	阝日ㄠ灬
茄	艹力口󰀘
髅	󰀾月米女
勒	廿口十力
努	女又力󰁣
蚰	虫由󰀝
绱	纟⺌冂口
禧	礻󰁶士口
圾	土乃󰂃󰁶
潲	氵禾⺌月
署	罒土丿日
轲	车丁口󰀝
咩	口丷󰅆󰀢
拭	扌󰀁工丶
溢	氵䒑八皿
健	亻󰁬󰀟廴
拨	扌ㄥ丿丶
几	几丿󰁊
搀	扌⺈口󰁦
兰	䒑二󰀘
腾	月䒑大一
匙	日一󰁾匕
耪	三󰅇亠方
扎	扌乚󰁀
攮	扌一口󰀔
陵	阝土八夂
柔	󰁻乛亅木
燠	火丿ㄇ大
犹	犭ノ丶
狨	犭ノ戈
还	丆卜辶󰀦
炕	火亠几󰁀
可	丁口󰀌
管	⺮宀丨󰁃
妁	女勹丶󰁶
埔	土一月丶
怿	忄又二丨
你	亻⺈小󰁶
羲	丷王禾丶
乱	丿古乚󰁀
沤	氵匚乂󰁶
眄	目一丨𠃌
菲	艹丨三三
透	禾乃辶󰀏
祥	礻󰁶丷󰅆
饥	⺈󰁐几󰁀
鼋	二儿口乚
烈	一夕刂灬
尒	人小󰁧
挨	扌厶𠂉大
孩	孑亠ㄥ人
垌	土冂一口
桡	木弋丿儿
爷	八乂ㄗ󰀬
位	亻立󰀝
鞔	廿󰀜⺈󰁜
笃	⺮󰀊一󰀘
造	丿土口辶
耠	三󰅇人口
茨	艹冫⺈人
厄	厂⺋󰁫
罕	冖八干󰀬
玄	亠ㄠ󰁧
婿	女乛󰁾月
魅	白󰁜厶󰅇
骄	󰀊󰀞丿󰀯
何	亻丁口󰀝
羟	䒑󰀠ス工
瘰	疒田ㄠ小
饿	⺈󰁐丿丶
欧	匚乂⺈人
噌	口丷󰀺日
亍	一丁󰀬
氧	󰅎⺄丷󰅆
仿	亻方ノ
陌	阝丆日󰀝
箨	⺮扌又󰀟
癌	疒口口山
忪	忄八厶󰁶
剔	日勹󰁤刂
溜	氵󰁚丶田
窕	宀八儿󰀪
亜	一口〢一
媾	女󰀀冂土
梧	木五口󰀝
劳	艹冖力󰁣
芳	艹方󰁣
广	广丶一丿
饺	⺈󰁐亠乂
塞	宀󰀀八土
馏	⺈󰁐󰁚田
娥	女丿扌丶
抠	扌匚乂󰁶
秘	禾心丿ノ
躜	口止丿贝
栩	木羽󰀝
砩	石弓󰀯󰀢
迪	由辶󰀌
遨	主󰁡夂辶
艄	丿󰁪⺌月
疏	乛止亠󰀸
钢	钅冂乂󰁶
骅	󰀊󰀞亻十
巍	山禾女厶
昌	日日󰀘
缲	纟口口木
柱	木丶王󰀝
捡	扌人一一
碟	石廿󰄃木
腑	月广亻寸
偲	亻田心󰁶
抨	扌一丷十
秕	禾󰁴匕󰁀
蓓	艹亻立口
冠	冖二儿寸
爹	八乂夕夕
掉	扌󰀥早󰀢
舔	丿古一⺗
莶	艹人一一
设	讠几又󰁶
勤	廿口主力
舒	人干口亅
邓	又阝󰀢
姚	女儿󰀪󰁶
熠	火羽白󰀝
芨	艹乃󰂃󰁧
黜	󰀹土灬山
钾	钅甲󰀢
溆	氵人一又
宽	宀艹ㄇ󰁜
峨	山丿扌丶
哪	口刀二阝
秦	三人禾󰁧
千	丿十󰀵
觅	爫ㄇ󰁜󰀅
碱	石厂一丶
袱	衤󰁧亻犬
兄	口儿󰀅
伍	亻五󰀝
缍	纟ノ一士
垩	一󰅊一土
鼍	口口田乚
帜	冂丨口八
券	䒑大刀󰁣
咤	口宀丿七
呒	口二󰁜󰁀
删	󰀼󰀼一刂
樗	木󰀙二ㄅ
胱	月⺌一儿
汹	氵乂凵󰀢
珩	王彳一丁
珈	王力口󰀝
镑	钅亠丷方
匈	勹乂凵󰀵
房	丶尸方󰀏
狄	犭ノ火󰁶
拄	扌丶王󰀝
漕	氵一ㄇ日
囔	口一口󰀔
鳎	󰁢󰀞日羽
狠	犭ノ彐󰀖
苠	艹󰁃󰁐弋
苄	艹亠卜󰁧
庆	广大󰀦
竿	⺮干󰀬
厉	厂一󰁡󰀏
稻	禾爫臼󰀝
乍	𠂉丨二󰀘
砰	石一丷十
箧	⺮匚一大
跞	口止丿小
蚌	虫三丨󰀢
妨	女方ノ
湍	氵山丆〢
侪	亻文󰀯󰀢
愠	忄日皿󰀝
婕	女一󰁬󰁾
乜	𠃌乚󰁫
筅	⺮丿土儿
龙	ヒ丶󰀦
纟	纟ㄥㄥ󰀞
虏	󰅋七力󰀏
蝗	虫白王󰀝
为	丶丿𠃌丶
极	木乃󰂃󰁶
嫂	女臼丨又
抄	扌小丿ノ
史	口乂󰀦
鹜	󰁻乛亅一
脶	月口冂人
妫	女丶丿丶
膀	月亠丷方
怨	夕⺋心󰁧
幞	冂丨󰅊人
衩	衤󰁧又丶
犄	ノ扌大
芄	艹九丶󰁧
桩	木广土󰀝
募	艹日大力
渺	氵目小丿
冢	冖一󰀓丶
奄	大日乚󰀅
蛘	虫丷󰅆󰀢
绎	纟又二丨
糜	广木木米
钓	钅勹丶󰁶
襄	亠口口󰀔
网	冂乂乂󰀦
粳	米一日乂
齑	文󰀯丨一
涌	氵󰁻用
鳊	󰁢󰀞丶艹
鸺	亻木勹一
踺	口止󰁬廴
痹	疒田一󰀯
叩	口卩󰀢
肆	󰀍厶󰁬󰀟
涕	氵丷弓丿
忸	忄󰁈丨二
缕	纟米女󰀝
菩	艹立口󰀘
簪	⺮󰀂󰁜日
揩	扌󰁴匕白
蠲	䒑八皿虫
槭	木厂󰀥丶
模	木艹日大
筻	⺮一日乂
謇	宀󰀀八言
畔	田䒑十󰀢
栲	木土丿ㄅ
镔	钅宀󰅍八
挹	扌口巴󰁀
猹	犭ノ木一
茹	艹女口󰀘
麓	木木广匕
躞	口止言又
酤	西一古󰀝
加	力口
攉	扌󰀙亻󰁷
淌	氵⺌冂口
呓	口艹乙󰁀
跌	口止󰅎人
麟	广󰁃〢丨
锩	钅䒑大⺋
爸	八乂巴󰀅
拦	扌丷三󰀝
匹	匚儿󰁫
峪	山八人口
泪	氵目󰀝
甩	月乚󰁫
肠	月ㄋ󰁤ノ
栎	木丿󰄃小
庚	广󰁬人󰀦
骡	󰀊󰀞田小
糍	米䒑ㄠㄠ
蔌	艹一口人
鳍	󰁢󰀞土日
髡	󰂞彡一儿
耱	三󰅇广石
逛	犭ノ王辶
涡	氵口冂人
糕	米丷王灬
藩	艹氵丿田
郾	匚日女阝
誉	󰀧一八言
骺	󰀾月⺁口
枋	木方ノ
回	囗口󰀌
俑	亻󰁻用
羰	䒑󰀠山火
攘	扌亠口󰀔
津	氵󰁬二丨
酋	丷西一󰀘
踅	扌斤口󰁾
煋	火曰丿
清	氵主月󰀝
克	古儿󰀅
毁	臼工几又
戚	厂󰀥一丶
沪	氵丶尸ノ
母	母󰄃𠃌丶
燮	言火火又
粪	米󰁺八󰁧
痔	疒土寸󰀦
臼	臼丿丨一
帕	冂丨白󰀝
丕	丆卜一󰀘
舄	臼勹灬󰁧
茬	艹丨土
聱	主󰁡夂耳
碲	石亠丷丨
叠	又又又一
揠	扌匚日女
珠	王󰅎󰅇󰁶
计	讠十󰀢
芹	艹斤󰀬
驽	女又󰀊一
抹	扌一木󰁶
妄	亠󰄃女󰀘
榄	木〢𠂉󰁜
禄	礻󰁶󰁭氺
媛	女爫一又
馄	⺈󰁐日匕
赌	贝土丿日
插	扌丿十臼
蛭	虫一厶土
哓	口弋丿儿
芬	艹八刀󰁣
孺	孑󰀙丆〢
钩	钅勹厶󰁶
硷	石人一一
璩	王󰅋七󰀓
刎	勹󰁤刂󰀢
喔	口尸一土
撩	扌大丷小
彘	󰅂一𠂉匕
含	人丶乛口
动	二厶力ノ
饲	⺈󰁐𠃌口
觫	⺈用󰅇
赜	匚丨口贝
持	扌土寸󰁶
浜	氵󰅍一八
疔	疒丁󰀵
赕	贝火火󰁶
礅	石󰁸孑攵
优	亻乚丶
桄	木⺌一儿
苹	艹一丷十
衄	丿皿󰁈二
欺	艹三八人
府	广亻寸󰀦
绞	纟亠八乂
赃	贝广土󰀝
浃	氵一丷大
惦	忄广󰀥口
僦	亻󰁸小乚
怄	忄匚乂󰁶
蛟	虫亠八乂
勹	勹丿𠃌
娩	女⺈口󰁜
缏	纟亻一乂
铩	钅乂木󰁶
贪	人丶乛贝
桔	木士口󰀝
洪	氵󰁺八󰁶
哩	口日土󰀝
泷	氵ヒ丶
囟	丿囗乂󰀦
岍	山一廾󰀢
脸	月人一一
楹	木乃又皿
耜	三󰅇丨󰁃
鲍	󰁢󰀞勹巳
奈	大二小󰁧
獠	犭ノ大小
荠	艹文󰀯󰀬
占	󰀥口󰀘
次	冫⺈人󰁶
翅	十又羽󰀌
迅	⺄十辶󰀵
必	心丿󰀏
踬	口止⺁贝
寺	土寸󰁧
俅	亻一氺丶
考	土丿一ㄅ
诺	讠艹口
惬	忄匚一大
威	厂一女丶
喏	口艹口
纣	纟寸󰁶
舆	󰀗车一八
徘	彳丨三三
毋	󰅂󰀌
胸	月勹乂凵
迕	𠂉十辶󰀵
惧	忄󰀣八󰁶
同	冂一口󰀌
翕	人一口羽
脱	月丷口儿
鄱	丿米田阝
槲	木⺈月十
焱	火火火󰁧
蒂	艹亠丷丨
鳜	󰁢󰀞厂人
榧	木匚丨三
莸	艹犭ノ丶
掠	扌󰁸小󰁶
寡	宀丆󰀐刀
诡	讠⺈厂⺋
篡	⺮目大厶
窝	宀八口人
尜	小大小󰁧
没	氵
瓠	大二ㄅ󰂃
摹	艹日大手
铠	钅山己󰁀
论	讠人匕󰁀
虎	󰅋七几󰁫
陟	阝止󰀤ノ
溏	氵广󰁬口
序	广󰁻乛亅
酵	西一土子
晟	日厂𠃌丶
龚	ヒ丶八
羚	䒑󰀠人󰁻
妩	女二󰁜󰁀
妲	女日一󰀝
哔	口󰁴匕十
衙	彳五口丁
怦	忄一丷十
哌	口⺁󰀕󰁶
腱	月󰁬󰀟廴
匪	匚丨三三
挪	扌刀二阝
铌	钅尸匕󰁀
迦	力口辶󰀌
罱	罒十冂十
礻	礻󰁶丶丶
校	木亠八乂
遛	󰁚丶刀辶
历	厂力󰀏
诘	讠士口󰀝
鍪	󰁻乛亅金
赛	宀󰀀八贝
禽	人文凵厶
袄	衤󰁧丿大
玹	王亠幺󰁶
莹	艹冖王丶
屺	山己󰁀
矿	石广ノ
彦	立丿彡󰀏
恳	彐󰀖心󰁧
野	日土󰁻亅
桦	木亻ヒ十
刨	勹巳刂󰀢
盥	󰀗水皿󰀘
爨	󰀗ㄇ一火
靖	立主月󰀝
励	厂一󰁡力
抱	扌勹巳󰁀
犊	ノ扌十大
颔	人丶乛贝
侠	亻一丷大
籍	⺮三󰅇日
群	󰁬丿口󰀟
和	禾口󰀝
夙	几一夕󰀦
掂	扌广󰀥口
蒌	艹米女󰀘
钌	钅了󰀢
鼠	臼󰁐󰁦󰁒
骗	󰀊󰀞丶艹
挠	扌弋丿儿
匠	匚斤󰀵
氡	󰅎⺄夂󰁦
箜	⺮宀八工
虿	一󰁡虫󰁧
宜	宀󰀐一󰀘
醛	西一艹王
胃	田月󰀘
烃	火ス工󰀝
虞	󰅋七口大
军	冖车󰀬
枥	木厂力ノ
箔	⺮氵白󰀘
膛	月⺌冖土
龅	止人凵巳
辅	车一月丶
芈	丨一󰀥󰀟
飙	大丶大乂
殍	一夕爫子
娲	女口冂人
英	艹ㄇ大󰁧
狱	犭󰁥讠犬
骋	󰀊󰀞由ㄅ
羞	䒑󰀠󰁈二
邾	󰅎󰅇阝󰀢
靥	厂大丶三
蝥	󰁻乛亅虫
早	早丨󰁈丨
苈	艹厂力󰁣
个	人丨󰀬
盹	目一凵乚
茂	艹厂󰅅丶
闩	门一󰀌
踪	口止宀小
峡	山一丷大
砹	石艹乂󰁶
恸	忄二厶力
泡	氵勹巳󰁀
钠	钅冂人󰁶
诜	讠丿土儿
改	󰁁夂󰁶
陲	阝ノ一士
蔹	艹人一夂
锹	钅禾火󰁶
仅	亻又󰁶
圄	囗五口󰀌
縻	广木木小
诔	讠三󰅇󰁶
耋	土丿匕土
霄	󰀙⺌月󰀘
爱	爫冖又
舱	丿󰁪人⺋
茌	艹亻士󰀘
恼	忄文凵
戊	厂󰅅丶󰀦
歃	丿十臼人
退	彐󰀖辶󰀦
钫	钅方ノ
绪	纟土丿日
蜩	虫󰀼土口
黪	󰀹土灬彡
嬷	女广木厶
欷	乂冂人
仪	亻
圩	土一󰀛󰀢
夯	大力󰁣
瘥	疒䒑󰀠工
平	一丷十󰀵
偃	亻匚日女
纺	纟方ノ
防	阝方ノ
恃	忄土寸󰁶
畹	田宀夕⺋
无	二󰁜󰁫
鲺	󰁢󰀞⺄虫
蕹	艹亠󰁲󰁷
创	人⺋刂󰀢
戛	丆目戈󰁧
麾	广木木乚
台	厶口󰀘
耢	三󰅇艹力
箱	⺮木目󰀘
菰	艹孑⺁󰂃
战	󰀥口戈󰁶
氍	目目亻乚
双	又又󰁶
谅	讠󰁸小󰁶
羼	尸丷󰅆󰀟
揄	扌人一刂
恍	忄⺌一儿
度	广廿又󰀦
纪	纟己󰁀
亢	亠几󰀅
革	廿󰀜󰀬
谍	讠廿󰄃木
庳	广白丿十
溪	氵爫ㄠ大
坩	土艹二󰀝
交	亠八乂󰁧
搠	扌䒑凵月
吠	口犬󰁶
釜	八乂干䒑
肃	󰁬󰅏󰀯󰀵
邃	宀八䒑辶
悃	忄囗木󰁶
象	⺈口󰀓󰁧
彝	󰅂一米廾
孔	孑乚󰁀
构	木勹厶󰁶
瞄	目艹田󰀝
楣	木󰁅目󰀝
鞫	廿󰀜勹言
捶	扌ノ一士
锄	钅󰀐󰀞力
厌	厂犬󰀦
掌	⺌冖口手
脏	月广土󰀝
氰	󰅎⺄主月
氅	⺌冂口乚
珏	王王丶󰁶
萧	艹󰁬󰅏󰀯
裒	亠臼󰀔󰁧
释	丿米又󰀟
飒	立几乂󰁶
罪	罒丨三三
蚩	凵丨一虫
魍	白󰁜厶󰄃
濮	氵亻󰅊人
铫	钅儿󰀪󰁶
螭	虫文凵厶
臃	月亠󰁲󰁷
燃	火󰁝大灬
窜	宀八口丨
贡	工贝󰁧
鞭	廿口十乂
鸢	弋勹丶一
郏	一丷大阝
赋	贝二止丶
躅	口止罒虫
鸵	勹丶ㄅ匕
铹	钅艹冖力
附	阝亻寸󰁶
就	高小󰅑乚
笱	⺮勹口󰀘
惋	忄宀夕⺋
印	󰁚一卩󰀢
芘	艹󰁴匕󰀅
渤	氵十冖力
窍	宀八工ㄅ
扌	扌一亅󰀞
噔	口癶一䒑
井	二󰀯󰀵
癔	疒立日心
晔	日亻ヒ十
陔	阝亠ㄥ人
雩	󰀙二ㄅ󰀅
蛩	工几丶虫
缪	纟羽人彡
曩	日亠口󰀔
弪	弓ス工󰀝
伪	亻丶丿丶
甥	丿主田力
泱	氵ㄇ大󰁶
疠	疒一󰁡󰀏
嘹	口大丷小
斓	文门一󰅇
崂	山艹冖力
阪	阝⺁又󰁶
淡	氵火火󰁶
巡	巛辶󰁫
阄	门⺈日乚
牛	󰅎丨󰀵
扛	扌工󰀝
嫔	女宀󰅍八
儋	亻⺈厂言
淅	氵木斤󰀢
现	王ㄇ󰁜󰁀
掰	八刀手
臂	尸口立月
莰	艹土⺈人
磋	石䒑󰀠工
吩	口八刀ノ
昔	󰁺日󰀘
戌	厂一󰅅丶
种	禾口丨󰀢
舌	丿古󰀌
蹼	口止󰅊人
吏	一口乂󰀦
席	广廿冂丨
阔	门氵丿古
幽	山ㄠㄠ󰀦
沢	氵尸󰂃󰁶
捞	扌艹冖力
沿	氵几口󰀝
帆	冂丨几丶
元	二儿󰀅
雾	󰀙夂力󰁣
协	十力八󰁶
鱿	󰁢󰀞丶
绠	纟一日乂
貊	豸丆日󰀝
验	󰀊󰀞人一
缅	纟丆冂三
恋	亠󰁗心󰁧
亡	亠󰄃󰁫
沱	氵宀匕󰁀
虹	虫工󰀝
纡	纟一󰀛󰀢
雄	厶亻󰁷
雠	亻󰁷讠󰁷
唾	口ノ一士
拌	扌䒑十󰀢
宪	宀丿土儿
苌	艹丿七󰂃
粱	氵刀八米
殪	一夕士䒑
鲱	󰁢󰀞丨三
讪	讠山󰀢
蚁	虫丶乂󰁶
鲞	䒑大󰁢一
瑶	王爫󰅎山
镬	钅艹亻又
应	广󰀧一󰀌
骝	󰀊󰀞󰁚田
妹	女二󰅇󰁶
嬲	田力女力
喹	口大土土
方	方丶一丿
赡	贝⺈厂言
弄	王廾󰀬
琥	王󰅋七几
唠	口艹冖力
锼	钅臼丨又
沆	氵亠几󰁀
的	白勹丶󰁶
肋	月力
鹅	丿扌󰁒一
蔬	艹乛止󰀸
筱	⺮亻丨夂
久	ク󰂃󰀦
疹	疒人彡󰀏
薹	艹士口土
瞌	目土厶皿
厩	厂彐厶󰁜
爰	爫一又
驱	󰀊󰀞匚乂
莩	艹爫子󰀘
幕	艹日大丨
汪	氵王󰀝
玩	王二儿󰁀
佩	亻几一丨
鹕	古月勹一
箫	⺮󰁬󰅏󰀯
综	纟宀二小
娇	女丿大󰀯
酃	󰀙口口阝
胶	月亠八乂
茏	艹ヒ丶
玛	王马󰀝
莛	艹丿士廴
馔	⺈󰁐巳八
鼯	臼󰁐󰁦口
罹	罒忄亻󰁷
嘁	口厂󰀥丶
霸	󰀙廿󰀜月
榔	木丶彐阝
仂	亻力ノ
滂	氵亠丷方
摘	扌亠丷古
氘	󰅎⺄󰀯󰀬
纩	纟广ノ
鸡	又勹丶一
榜	木亠丷方
尕	乃小󰁧
掷	扌䒑大阝
涿	氵一󰀓丶
评	讠一丷十
骟	󰀊󰀞丶羽
详	讠丷󰅆󰀢
嵯	山䒑󰀠工
壳	士冖几󰀅
晁	日儿󰀪󰁧
憋	丷冂󰅏心
桃	木儿󰀪󰁶
趄	土󰁾󰀐一
醋	西一󰁺日
碓	石亻󰁷󰀝
铘	钅󰀂亅阝
墓	艹日大土
梓	木辛󰀢
扉	丶尸丨三
槔	木白大十
委	禾女󰀘
珧	王儿󰀪󰁶
蛸	虫⺌月󰀝
斗	󰁦十󰀵
蔻	艹宀二又
纹	纟文󰁶
酶	西一𠂉母
砺	石厂一󰁡
姜	丷王女󰀘
仡	亻𠂉乙󰁀
绡	纟⺌月󰀝
满	氵艹一人
垅	土ヒ丶
扃	丶尸冂口
旷	日广ノ
烂	火丷三󰀝
飨	󰁲丿人󰀖
闷	门心󰀦
磨	广木木石
裨	衤󰁧白十
规	二人ㄇ󰁜
畋	田夂󰁶
嘌	口覀二小
递	丷弓丨辶
擘	尸口立手
尤	乚丶󰀦
桓	木一日一
倒	亻一厶刂
觌	十乛󰁦󰁜
嗷	口主󰁡夂
谤	讠亠丷方
斧	八乂斤󰀬
琛	王冖八木
焓	火人丶口
脓	月冖󰀔󰁶
搛	扌䒑󰁬󰁗
箝	⺮扌艹二
螋	虫臼丨又
夜	亠亻夂丶
澡	氵口口木
羡	丷王冫人
蟠	虫丿米田
愿	厂白小心
儿	儿丿乚
趿	口止乃󰂃
睨	目臼儿󰁀
鄯	丷󰅆䒑阝
螨	虫艹一人
翩	丶尸冂羽
枨	木丿七󰂃
猃	犭ノ人一
范	艹氵⺋󰀅
磅	石亠丷方
吸	口乃󰂃󰁶
蒡	艹亠丷方
诽	讠丨三三
洄	氵囗口󰀝
牯	ノ扌古󰀝
铗	钅一丷大
猷	丷西一犬
牧	ノ扌夂󰁶
鲰	󰁢󰀞耳又
藓	艹󰁢󰀞󰀟
焰	火⺈臼󰀝
武	二止󰁒丶
弹	弓丷曰十
痞	疒丆卜口
避	尸口立辶
楔	木三丨大
奔	大十廾󰀬
幡	冂丨丿田
乡	󰁲丿󰀏
郄	乂厶阝
凶	乂凵󰀵
狃	犭ノ󰁈二
宠	宀ヒ丶
祜	礻󰁶古󰀝
映	日ㄇ大󰁶
饨	⺈󰁐一乚
汰	氵大丶󰁶
蔗	艹广廿灬
嘞	口廿口力
勰	力力力心
扩	扌广ノ
票	覀二小󰁧
物	ノ扌勹󰁤
蔑	艹罒厂丶
懋	木󰁻乛心
漉	氵广󰁃匕
资	冫⺈人贝
穷	宀八力󰁣
炒	火小丿ノ
悒	忄口巴󰁀
荷	艹亻丁口
核	木亠ㄥ人
虼	虫𠂉乙󰁀
竹	𠂉丨𠂉亅
砸	石匚冂丨
劾	亠ㄥ丿力
糠	米广󰁬氺
颜	立丿彡贝
搜	扌臼丨又
嚯	口󰀙亻󰁷
袜	衤󰁧一木
坠	阝人土󰀘
杠	木工󰀝
鸨	匕十勹一
蚯	虫󰅍一󰀝
肛	月工󰀝
鲔	󰁢󰀞月
蹙	戊上小󰁾
贰	弋二贝丶
髦	󰀍厶彡乚
陇	阝ヒ丶
烀	火丿丷󰀛
呸	口丆卜一
牲	ノ扌丿
梅	木𠂉母󰁶
粝	米厂一󰁡
扶	扌二人󰁶
牾	ノ扌五口
艾	艹乂󰁧
顸	干丆贝󰁶
找	扌戈󰁶
犋	ノ扌󰀣八
芋	艹一󰀛󰀬
羹	丷王灬大
边	力辶󰀏
埸	土日勹󰁤
澹	氵⺈厂言
峄	山又二丨
鞠	廿󰀜勹米
呼	口丿丷󰀛
糸	幺小󰁧
濡	氵󰀙丆〢
盯	目丁󰀢
捃	扌󰁬丿口
瞠	目⺌冖土
謦	士󰁅几言
茉	艹一木󰁧
信	亻言󰀝
雯	󰀙文󰁧
铷	钅女口󰀝
琉	王亠厶󰀸
键	钅󰁬󰀟廴
榇	木立木󰁶
荃	艹人王󰀘
僧	亻丷󰀺日
绰	纟󰀥早󰀢
烧	火弋丿儿
违	二𠃌丨辶
郧	口贝阝󰀢
脑	月文凵
泄	氵廿󰄃󰁀
滴	氵亠丷古
蓣	艹󰁻乛贝
怒	女又心󰁧
婀	女阝丁口
姗	女󰀼󰀼一
蛑	虫厶󰅎丨
斌	文二止丶
码	石󰀊一󰀝
黹	󰅊一丷󰅏
耿	耳火󰁶
瓮	八厶一丶
吃	口𠂉乙󰁀
笮	⺮𠂉丨二
尔	⺈小󰁧
咒	口口几󰀅
笺	⺮戋󰁣
谔	讠口口ㄅ
唏	口乂丨
气	󰅎⺄󰀅
伞	人
斜	人
蘑	艹广木石
牡	ノ扌土󰀝
逯	󰁭氺辶󰀦
骢	󰀊󰀞丿心
桁	木彳一丁
梨	禾刂木󰁧
墨	󰀹土灬土
耀	⺌一儿󰁷
球	王一氺丶
萃	艹亠人十
臧	厂󰄃丆丶
乐	丿󰄃小󰀦
谄	讠⺈臼󰀝
射	丿󰀽三寸
晃	日⺌一儿
馅	⺈󰁐⺈臼
祚	礻󰁶𠂉二
荼	艹人一木
枷	木力口󰀝
涝	氵艹冖力
酆	山三丨阝
访	讠方ノ
邛	工阝󰀢
獬	犭ノ⺈󰀟
罡	罒一止󰀘
景	曰󰁸小󰁧
癯	疒目目󰁷
烛	火虫󰁶
鹨	羽人彡一
郛	爫孑阝󰀢
胛	月甲󰀢
走	土󰁾󰁧
陷	阝⺈臼󰀝
晷	日夂卜口
兆	儿󰀪󰀦
栳	木土丿匕
悱	忄丨三三
唪	口三人󰀟
驺	󰀊󰀞⺈彐
叻	口力ノ
凫	勹丶ㄅ几
务	夂力󰁣
驸	󰀊󰀞亻寸
聿	󰁬󰀟󰀵
勋	口贝力ノ
苋	艹ㄇ󰁜󰀅
柝	木斤丶󰁶
龌	止人凵土
蜍	虫人一木
羌	䒑二󰁜󰀅
侔	亻厶󰅎丨
劓	丿目田刂
抓	扌⺁丨󰂃
柚	木由󰀝
特	ノ扌土寸
夸	大二ㄅ󰀅
妤	女󰁻乛亅
掳	扌󰅋七力
枰	木一丷十
濒	氵止󰀤贝
压	厂土丶󰀦
殄	一夕人彡
王	王王王王
蜊	虫禾刂󰀢
搓	扌䒑󰀠工
潋	氵人一夂
圊	囗主月󰀌
薷	艹󰀙丆〢
杜	木土󰀝
冧	冖木木󰁧
喷	口十艹贝
丰	三丨󰀵
希	乂冂丨
翡	三〢三羽
璃	王文凵厶
逮	󰁬氺辶󰀦
笨	⺮木一󰀘
羔	丷王灬󰁧
醯	西一亠皿
滔	氵爫臼󰀝
翌	羽立󰀘
裤	衤󰁧广车
船	丿󰁪几口
啛	口一󰁬女
街	彳土土丁
打	扌丁󰀢
忌	己心󰁧
懿	士冖一心
暝	日冖曰六
柰	木二小󰁧
凿	󰅊一䒑凵
辱	厂二󰀖寸
烯	火乂丨
裸	衤󰁧日木
谖	讠爫一又
凯	山󰁁几󰁀
仝	人工󰀘
圜	囗罒一󰀔
槠	木讠土日
垓	土亠ㄥ人
非	三〢三
劭	刀口力ノ
犭	犭ノ丿丿
镛	钅广󰁬丨
返	⺁又辶󰀦
畛	田人彡ノ
敛	人一󰀧夂
绝	纟⺈巴󰁀
蜜	宀心丿虫
霜	󰀙木目󰀘
諨	言一口田
耩	三󰅇󰀀土
虢	爫寸󰅋几
褐	衤󰁧日󰄃
舫	丿󰁪方ノ
鼐	乃目󰁕󰁈
庙	广由󰀌
崴	山厂一丶
惕	忄日勹󰁤
频	止󰀤丆贝
笾	⺮力辶󰁧
揾	扌曰皿󰀝
薛	艹亻󰁃十
搋	扌⺁󰅋几
缌	纟田心󰁶
饬	⺈󰁐𠂉力
衤	衤󰁧丶丶
腻	月弋二丶
锷	钅口口ㄅ
萋	艹一󰁬女
埕	土口王󰀝
许	讠𠂉十󰀢
猿	犭ノ土󰀔
蔷	艹十䒑口
宸	宀厂二󰀖
颠	十󰀣八贝
助	󰀐󰀞力ノ
馨	士󰁅几日
茯	艹亻犬󰁧
瘛	疒三丨心
袤	亠󰁻乛󰀔
嘛	口广木木
演	氵宀一八
缔	纟亠丷丨
男	田力󰁣
苓	艹人丶󰁻
矜	󰁻乛亅乛
拓	扌石󰀝
恐	工几丶心
颦	止󰀤丆十
纲	纟冂乂󰁶
舁	臼廾󰀬
奸	女干󰀢
楸	木禾火󰁶
祸	礻󰁶口人
友	又󰁧
酿	西一丶󰀖
蛄	虫古󰀝
黝	󰀹土灬力
魄	白白󰁜厶
翔	䒑󰀠羽󰀝
鹰	广亻亻一
蹈	口止爫臼
果	日木󰀦
照	日刀口灬
啷	口丶彐阝
敷	一󰀐丨夂
铃	钅人丶󰁻
买	乛󰁦大󰁧
腧	月人一刂
醭	西一󰅊人
东	󰀂小󰀦
废	广ㄥ丿丶
酯	西一匕日
罔	冂䒑亠󰄃
骂	口口󰀊一
力	力𠃌丿
抛	扌九力ノ
坜	土厂力ノ
羝	䒑󰀠󰁚丶
冯	冫󰀊一󰀝
稀	禾乂丨
兑	丷口儿󰀅
二	二一一
啫	口土丿日
咋	口𠂉丨二
檄	木白方夂
莓	艹𠂉母󰁧
叙	人一木又
霰	󰀙󰁺月夂
轱	车古󰀝
炯	火冂口󰀝
傧	亻宀󰅍八
邯	艹二阝󰀢
肯	止月󰀘
窄	宀八𠂉二
蒋	艹丬夕寸
钋	钅卜󰁶
便	亻一日乂
飘	覀二小乂
抬	扌厶口󰀝
铅	钅几口󰀝
假	亻󰁃丨又
疃	田立日土
麝	广󰁃〢寸
喃	口十冂十
癜	疒尸󰁺又
仔	亻子󰀝
飚	几乂火火
窈	宀八ㄠ力
餍	厂大丶󰀖
殴	匚乂几又
仑	人匕󰀅
墼	車凵几土
叼	口𠃌󰀞󰀝
滹	氵󰅋七󰀛
裰	衤󰁧又又
秸	禾士口󰀝
散	󰁺月夂󰁶
绌	纟凵山󰀢
莪	艹丿扌丶
声	士󰁅󰁣
棰	木ノ一士
拧	扌宀丁󰀢
郯	火火阝󰀢
距	口止匚󰁃
阜	亻󰁃󰁃十
毫	󰁸冖ノ
氖	󰅎⺄乃󰁣
呕	口匚乂󰁶
枢	木匚乂󰁶
胧	月ヒ丶
砜	石几乂󰁶
鹧	广廿灬一
黔	󰀹土灬乛
侩	亻人二厶
绔	纟大二ㄅ
蕃	艹丿米田
川	川丿丨丨
挛	亠󰁗手󰀬
稔	禾人丶心
昃	日厂人󰁧
瘃	疒一󰀓丶
藁	艹󰁸冂木
阃	门囗木󰀦
茛	艹彐󰀖󰁧
腓	月丨三三
忱	忄冖󰁜󰁀
渌	氵󰁭氺󰁶
瞰	目乛耳夂
踌	口止三寸
笈	⺮乃󰂃󰁧
耷	大耳󰀘
垭	土一󰅊一
丌	一󰀯󰀵
伝	亻二厶󰁶
晦	日𠂉母󰁶
曜	日羽亻󰁷
级	纟乃󰂃󰁶
锋	钅夂三丨
遽	󰅋七一辶
邝	广阝󰀢
眺	目儿󰀪󰁶
彻	彳七刀ノ
貔	豸丿囗匕
忤	忄𠂉十󰀢
豫	󰁻乛亅󰀓
耧	三󰅇米女
缝	纟夂三辶
舯	丿󰁪口丨
窨	宀八立日
飓	几乂󰀣八
蹴	口止亠丶
燕	廿口丬灬
招	扌刀口󰀝
猸	犭󰁥󰁅目
苛	艹丁口󰀘
勃	十冖孑力
鼹	臼󰁐󰁦女
穸	宀八夕󰁧
缱	纟口丨辶
橄	木乛耳夂
哋	口土也󰁀
鹌	大日󰁐一
菓	艹曰木󰁧
偿	亻⺌冖厶
恿	󰁻用心󰁧
息	丿目心󰁧
灯	火丁󰀢
表	主󰀔󰁧
九	九丿󰁊
脎	月乂木󰁶
彳	彳丿丿丨
初	衤󰁧刀ノ
铋	钅心丿ノ
彬	木木彡ノ
彡	彡丿丿丿
庶	广廿灬󰀦
鹿	广󰁃〢匕
障	阝立早󰀢
痃	疒亠ㄠ󰀦
祠	礻󰁶𠃌口
蚜	虫󰀂亅丿
吗	口󰀊一󰀝
鸥	匚乂勹一
灰	火󰁧
舅	臼田力󰁣
镨	钅䒑󰅊日
恰	忄人一口
君	󰁬丿口󰀌
麻	广木木󰀦
獾	犭ノ艹󰁷
殿	尸󰁺八又
垛	土几木󰁶
贩	贝⺁又󰁶
斋	文丆冂〢
疋	乛󰁾󰀦
嚷	口亠口󰀔
葛	艹日勹󰄃
镜	钅立日儿
吒	口丿七󰁀
畜	亠ㄠ田󰀘
控	扌宀八工
仄	厂人󰀦
寿	三丿寸󰁧
斛	⺈用󰁦十
幅	冂丨一田
盼	目八刀ノ
庹	广廿尸󰂃
酗	西一乂凵
羧	䒑󰀠厶夂
娠	女厂二󰀖
玑	王几󰁀
燹	一󰀓一火
颓	禾几丆贝
裱	衤󰁧主󰀔
谀	讠臼人󰁶
癃	疒阝夂主
焊	火日干󰀢
淄	氵巛田󰀝
奋	大田󰀘
棱	木土八夂
帐	冂丨丿󰂃
厨	厂一口寸
谲	讠󰁻乛口
猛	犭ノ子皿
轹	车丿󰄃小
睛	目主月󰀝
诩	讠羽󰀝
铒	钅耳󰀝
推	扌亻󰁷󰀝
瓒	王丿土贝
除	阝人一木
哒	口大辶󰁶
擒	扌人亠厶
眸	目厶󰅎丨
役	彳几又󰁶
宿	宀亻丆日
诠	讠人王󰀝
觥	⺈用⺌儿
浠	氵
举	󰅗八二
阡	阝丿十󰀢
札	木乚󰁀
豚	月豕󰁶
涩	氵刀丶止
栈	木戋󰁥
养	丷󰂃󰀯
蜃	厂二󰀖虫
件	亻
凭	亻
俄	亻
链	钅车辶󰁶
铨	钅人王󰀝
余	人
崔	山亻󰁷󰀘
恚	土土心󰁧
岩	山石󰀘
凰	几白王󰀌
榱	木亠口󰀔
阋	门臼儿󰁫
洌	氵一夕刂
钒	钅几丶󰁶
窠	宀八日木
渝	氵人一刂
撒	扌󰁺月夂
踝	口止日木
线	纟戋
浅	氵戋󰁥
盏	戋皿󰀘
蠛	虫艹罒丶
熹	士口䒑灬
畚	厶大田󰀘
驶	马口乂
饯	⺈󰁐戋
残	一夕戋
讥	讠几󰁀
嗜	口土丿日
丝	󰁲󰁲一󰀘
讽	讠几乂
抗	扌亠几󰁀
迈	丆𠃌辶
藏	艹厂󰁏ノ
锾	钅爫一又
锨	钅斤⺈人
甾	巛田󰀘
韵	立日勹冫
浩	氵丿土口
嵩	山󰁸冂口
浔	氵彐寸󰁶
用	用丿𠃌丨
髫	󰂞彡刀口
旋	方𠂉乛󰁾
贺	力口贝
卤	󰀥囗
荧	艹冖火󰁧
车	车一ㄥ丨
捧	扌三人
凤	几又
赔	贝立口󰀝
矛	󰁻乛亅丿
匿	匚艹口
蓄	艹亠ㄠ田
城	土厂
冈	冂乂
姿	冫⺈人女
嗽	口一口人
捕	扌一月丶
卧	匚丨󰁃卜
兵	󰅍一八󰁧
润	氵门王󰀝
肤	月二人󰁶
蔽	艹丷冂夂
胲	月亠ㄥ人
螃	虫亠丷方
垃	土立󰀝
毯	丿二乚火
撖	扌乛耳夂
咛	口宀丁󰀢
箅	⺮田一󰀯
失	󰅎人󰀦
皋	白大十󰀬
蚋	虫冂人󰁶
沌	氵一凵乚
酰	西一丿儿
慰	尸二小心
窿	宀八阝主
讦	讠干󰀢
媒	女艹二木
貌	豸白儿󰁀
敞	⺌冂口夂
葜	艹三丨大
瑜	王人一刂
犯	犭ノ⺋󰁀
呜	口勹ㄅ一
殊	一夕󰅎󰅇
芯	艹心󰁧
虑	󰅋七心󰀦
钛	钅大丶󰁶
澜	氵门一󰅇
宾	宀󰅍一八
降	阝夂󰀂丨
入	丿󰂃󰀦
眞	匕目󰄃八
睃	目厶八夂
鹉	一󰀁止一
壶	士冖󰅊一
限	阝彐󰀖󰁶
瘭	疒覀二小
权	木又󰁶
钨	钅勹ㄅ一
泔	氵艹二󰀝
璨	王󰀥夕米
泠	氵人丶󰁻
咨	冫⺈人口
话	讠丿古󰀝
铧	钅亻ヒ十
糌	米夂卜日
泌	氵心丿ノ
鳌	主󰁡夂一
诂	讠古󰀝
琪	王艹三八
埠	土亻󰁃十
拯	扌了󰀩一
狯	犭ノ人厶
爝	火爫罒寸
姨	女一弓人
氮	󰅎⺄火火
某	艹二木󰁧
苯	艹木一󰀘
珥	王耳󰀝
诧	讠宀丿七
琅	王丶彐󰀖
屙	尸阝丁口
潍	氵纟亻󰁷
邱	󰅍󰀞阝󰀢
束	一口󰅇󰀦
整	一口󰅇止
煤	火艹二木
骱	󰀾月人󰀯
唛	口主夂󰁶
鹗	口口二一
赚	贝䒑󰁬󰁗
看	目󰀘
拳	䒑大手󰀬
狰	犭ノ⺈亅
朋	月月󰀝
恂	忄勹日󰀝
拆	扌斤丶󰁶
聂	耳又又󰁧
遂	䒑󰀓辶󰀦
邶	丬󰁴阝󰀢
铜	钅冂一口
业	󰅊一󰀌
垠	土彐󰀖󰁶
簌	⺮一口人
哜	口文󰀯󰀢
讠	讠丶󰁉
瓜	⺁厶󰂃󰀦
刍	⺈彐󰀘
锛	钅大十廾
歉	䒑󰁬󰁗人
墟	土󰅋七一
菠	艹氵󰅌又
舞	󰅎󰀷一丨
蒲	艹氵一丶
暧	日爫冖又
来	一米󰀦
窑	宀八󰅎山
皮	󰅌又󰀦
耘	三󰅇二厶
柃	木人丶󰁻
埃	土厶𠂉大
食	人丶彐󰀖
症	疒一止󰀌
诿	讠禾女󰀝
鐾	尸口立金
蛋	乛󰁾虫󰁧
剩	禾丬匕刂
饱	⺈󰁐勹巳
缸	󰅎山工󰀝
屌	尸口冂丨
楱	木三人大
氟	󰅎⺄弓󰀯
隆	阝夂一主
钜	钅匚󰁃󰀝
豌	一口䒑⺋
璜	王󰁺由八
蒜	艹二小小
扯	扌止󰀝
汝	氵女󰀝
良	丶彐󰀖󰀦
博	十一月寸
铛	钅⺌彐󰀝
旗	方𠂉艹八
瞥	丷冂󰅏目
舰	丿󰁪ㄇ󰁜
艰	又彐󰀖󰁶
嫌	女䒑󰁬󰁗
缩	纟宀亻日
型	一廾刂土
澄	氵癶一䒑
阑	门一󰀹󰅇
辄	车耳乚󰁀
龄	止人凵󰁻
弩	女又弓󰀅
杨	木ㄋ󰁤ノ
嚓	口宀󰁯小
境	土立日儿
卜	卜丨丶
樱	木贝贝女
胂	月日丨󰀢
颃	亠几丆贝
梃	木丿士廴
谠	讠⺌冖儿
歼	一夕丿十
晋	一󰅊一日
氩	󰅎⺄一一
歇	日勹人人
歆	立日⺈人
脚	月土厶卩
皓	白丿土口
蚓	虫弓丨󰀢
锓	钅彐冖又
檗	尸口立木
匣	匚甲󰀵
毽	丿二乚廴
显	日󰅊一󰀘
瘾	疒阝⺈心
缚	纟一󰀐寸
圈	囗䒑大⺋
鸟	勹丶ㄅ一
甜	丿古艹二
巩	工几丶󰁶
乒	󰅍一丿󰁣
氚	󰅎⺄川󰀬
逢	夂三丨辶
艇	丿󰁪丿廴
薨	艹罒冖匕
猜	犭ノ主月
茜	艹西󰀘
晓	日弋丿儿
富	宀一口田
溉	氵彐厶󰁜
怂	人人心󰁧
适	丿古辶󰀌
淠	氵田一󰀯
速	一口󰅇辶
榛	木三人禾
狼	犭ノ丶󰀖
嘣	口山月月
诌	讠⺈彐󰀝
篌	⺮亻ユ大
唳	口丶尸犬
踉	口止丶󰀖
诰	讠丿土口
朊	月二儿󰁀
柘	木石󰀝
耄	土丿匕乚
啾	口禾火󰁶
惯	忄󰅂十贝
捋	扌爫寸󰁶
寄	宀大丁口
迹	亠󰁖辶󰀦
缄	纟厂一丶
枸	木勹口󰀝
垸	土宀二儿
厮	厂艹三斤
腿	月彐󰀖辶
聊	耳󰁚丿卩
亩	亠田󰀘
尝	⺌冖二厶
坞	土勹ㄅ一
铊	钅宀匕󰁀
鸠	九勹丶一
鲠	󰁢󰀞一乂
谝	讠丶尸艹
瞩	目尸丿丶
旖	方𠂉大口
槛	木〢𠂉皿
冚	冖山󰀬
凋	冫󰀼土口
寐	宀󰄃丨󰅇
棘	一冂󰅇󰅇
滕	月䒑大氺
舟	丿󰁪󰀦
袅	勹丶ㄅ󰀔
追	亻󰁃󰁃辶
磷	石米夕丨
蜓	虫丿士廴
霓	󰀙臼儿󰀅
耥	三󰅇⺌口
喾	󰀧冖丿口
很	彳彐󰀖󰁶
疾	疒𠂉大󰀦
轩	车干󰀢
眨	目丿之󰁶
罄	士󰁅几山
摔	扌亠ㄠ十
齄	丿目田一
蟋	虫丿米心
木	木木木木
彩	爫木彡ノ
池	氵也󰁀
筝	⺮⺈󰁬亅
橱	木厂一寸
屠	尸土丿日
邂	⺈用刀辶
发	ㄥ丿又丶
莜	艹亻丨夂
镧	钅门一󰅇
掬	扌勹米󰁶
艚	丿󰁪一日
佚	亻󰅎人󰁶
敕	一口󰅇夂
谣	讠爫󰅎山
圃	囗一月丶
毡	丿二乚口
筌	⺮人王󰀘
瀛	氵亠󰄃丶
敝	丷冂󰅏夂
麸	主夕二人
氪	󰅎⺄古儿
黉	󰀧冖󰁺八
繇	爫󰅎山小
偾	亻十艹贝
虚	󰅋七󰅊一
烊	火丷󰅆󰀢
袋	亻弋亠󰀔
郊	亠八乂阝
掣	󰅎冂丨手
蚝	虫丿二乚
瑾	王廿口主
庄	广土󰀌
惊	忄󰁸小󰁶
号	口一ㄅ󰀅
覃	覀早󰀬
妃	女己󰁀
素	主ㄠ小󰁧
五	五一丨一
剜	宀夕⺋刂
谩	讠日罒又
屋	尸一厶土
躔	口止广土
鳖	丷冂󰅏一
橛	木厂䒑人
刚	冂乂刂󰀢
牙	󰀂亅丿󰀏
撷	扌士口贝
鹞	爫󰅎山一
孖	孑子󰀝
螓	虫三人禾
放	方夂󰁶
钷	钅匚口󰀝
瞓	目言川󰀢
普	䒑󰅊一日
侏	亻󰅎󰅇󰁶
碰	石䒑󰅊一
墅	日土󰁻土
组	纟󰀐一󰀝
怊	忄刀口󰀝
蚨	虫二人󰁶
绩	纟主贝󰁶
滩	氵又亻󰁷
鄂	口口二阝
逊	孑小辶󰀦
黠	󰀹土灬口
藉	艹三󰅇日
胡	古月󰀝
脂	月匕日󰀝
地	土也󰁀
簸	⺮艹三又
鳞	󰁢󰀞米丨
腼	月丆冂三
啥	口人干口
怃	忄二󰁜󰁀
古	古一丨一
峰	山夂三丨
泰	三人氺󰁧
形	一廾彡ノ
摅	扌󰅋七心
耙	三󰅇巴󰁀
莆	艹一月丶
崃	山一米󰁶
杓	木勹丶󰁶
靓	主月ㄇ󰁜
岿	山リ彐󰀘
狷	犭ノ口月
苷	艹艹二󰀘
筠	⺮土勹冫
鸣	口勹丶一
酊	西一丁󰀢
掼	扌󰅂十贝
鸿	氵工勹一
腊	月󰁺日󰀝
饵	⺈󰁐耳󰀝
椋	木󰁸小󰁶
磔	石夕󰀂木
仙	亻山󰀢
苜	艹目󰀘
叨	口刀ノ
呋	口二人󰁶
逋	一用辶
渔	氵󰁢一󰀝
牖	丿丨一丶
涠	氵囗二丨
箩	⺮罒夕󰁧
奠	丷西一大
爿	󰄃丨丆󰀏
踔	口止󰀥早
镦	钅󰁸孑攵
宰	宀辛󰀬
银	钅彐󰀖󰁶
谰	讠门一󰅇
倦	亻䒑大⺋
遒	丷西一辶
记	讠己󰁀
屿	山一ㄅ一
甚	艹三八󰄃
娌	女日土󰀝
恒	忄一日一
锻	钅亻三又
聒	耳丿古󰀝
蹄	口止亠丨
炊	火⺈人󰁶
匍	勹一月丶
鹄	丿土口一
橇	木丿二乚
葚	艹艹三󰄃
湄	氵󰁅目󰀝
幄	冂丨尸土
膂	方𠂉󰀕月
秃	禾几󰀅
吨	口一凵乚
冂	冂丨𠃌
琨	王日󰁴匕
汩	氵日󰀝
盛	厂𠃌󰅅皿
湔	氵䒑月刂
瞵	目米夕丨
蛛	虫󰅎󰅇󰁶
昧	日二󰅇󰁶
溥	氵一月寸
缺	󰅎山ユ人
瑷	王爫冖又
湎	氵丆冂三
孰	󰁸孑九丶
濑	氵一口贝
蟓	虫⺈口󰀓
耨	三󰅇厂寸
染	氵九木󰁧
氛	󰅎⺄八刀
蠃	亠󰄃口丶
嗾	口方𠂉大
丿	丿丿〇〇
测	氵贝刂󰀢
郑	䒑大阝󰀢
甘	艹二󰀌
氙	󰅎⺄山󰀬
惑	戈口󰀞心
耒	三󰅇󰀦
讷	讠冂人󰁶
砒	石󰁴匕󰁀
诛	讠󰅎󰅇󰁶
鞯	廿󰀜艹子
禊	礻󰁶三大
圹	土广ノ
枯	木古󰀝
绺	纟夂卜口
螯	主󰁡夂虫
霹	󰀙尸口辛
膊	月一󰀐寸
媵	月䒑大女
绻	纟䒑大⺋
嘶	口艹三斤
睾	丿罒土十
啵	口氵󰅌又
棋	木艹三八
巷	󰁺八巳󰀅
筛	⺮リ一丨
挚	扌九丶手
孛	十冖子󰀘
舜	爫冖夕丨
耖	三󰅇小丿
怏	忄ㄇ大󰁶
嬴	亠󰄃口丶
茚	艹󰁚一卩
懊	忄丿ㄇ大
燊	火火火木
臊	月口口木
馋	⺈󰁐⺈󰁦
瀑	氵日󰁺氺
窃	宀八七刀
筷	⺮忄ユ人
棒	木三人󰀟
耗	三󰅇丿乚
帙	冂丨󰅎人
缣	纟䒑󰁬󰁗
椴	木亻三又
坯	土丆卜一
杯	木丆卜󰁶
洚	氵夂󰀂丨
唧	口彐厶卩
湛	氵艹三󰄃
舸	丿󰁪丁口
铼	钅一米󰁶
簿	⺮氵一寸
睐	目一米󰁶
籁	⺮一口贝
誊	䒑大言󰀘
蚶	虫艹二󰀝
殷	⺁彐𠃌又
龈	止人凵󰀖
乌	勹ㄅ一󰀌
澌	氵艹三斤
辚	车米夕丨
氆	丿二乚日
宛	宀夕⺋󰀅
殛	一夕了一
秋	禾火󰁶
艋	丿󰁪子皿
庠	广丷󰅆󰀵
遑	白王辶󰀌
袒	衤󰁧日一
滗	氵⺮丿乚
劂	厂䒑凵刂
墒	土亠丷口
佺	亻人王󰀝
辨	辛丶丿辛
羨	丷王氵人
惮	忄丷曰十
轺	车刀口󰀝
隹	亻󰁷󰀝
暹	日亻󰁷辶
膦	月米夕丨
艨	丿󰁪艹󰀓
赙	贝一月寸
毹	人一月乚
旄	方𠂉丿乚
黼	󰅊一丷丶
舻	丿󰁪󰀥尸
趺	口止二人
餮	一夕人󰀖
厶	厶ㄥ丶
谌	讠艹三󰄃
卷	䒑大⺋󰀅
茱	艹󰅎󰅇󰁧
脯	月一月丶
嫠	二󰅇夂女
毛	丿二乚󰁫
厚	厂日子󰀌
习	𠃌冫󰀌
农	冖󰀔󰀦
剌	一口󰅇刂
捂	扌五口󰀝
膜	月艹日大
茶	艹人木󰁧
楝	木一󰀹󰅇
祝	礻󰁶口儿
迨	厶口辶󰀌
虔	󰅋七文󰀦
茑	艹勹丶一
人	人人人人
睹	目土丿日
溺	氵弓冫冫
鬃	󰂞彡宀小
躺	丿󰀽三口
笔	⺮丿二乚
寤	宀󰄃丨口
姝	女󰅎󰅇󰁶
晡	日一月丶
僮	亻立日土
侨	亻丿大󰀯
鹣	䒑󰁬󰁗一
浪	氵丶彐󰀖
淇	氵艹三八
嵌	山艹二人
瑚	王古月󰀝
礓	石一田一
褓	衤󰁧亻木
酒	氵西一󰀝
氤	󰅎⺄囗大
蜞	虫艹三八
蚧	虫人󰀯󰀢
缠	纟广日土
漠	氵艹日大
张	弓丿七󰂃
传	亻二󰁓丶
漱	氵一口人
舳	丿󰁪由󰀝
祺	礻󰁶艹八
陶	阝勹󰅎山
根	木彐󰀖󰁶
灸	ク󰂃火󰁧
蠹	一口丨虫
刊	干刂󰀢
浦	氵一月丶
蒹	艹䒑󰁬󰁗
俺	亻大日乚
蒗	艹氵丶󰀖
帔	冂丨󰅌又
纯	纟一凵乚
溯	氵䒑凵月
瘌	疒一口刂
虮	虫几󰁀
朱	󰅎󰅇󰀦
蘧	艹󰅋七辶
儒	亻󰀙丆〢
潜	氵二人日
祓	礻󰁶丶
琚	王尸古󰀝
汛	氵⺄十󰀢
脒	月米󰁶
怜	忄人丶󰁻
焦	亻󰁷灬󰁧
它	宀匕󰀅
殃	一夕ㄇ大
秩	禾󰅎人󰁶
徕	彳一米󰁶
嫩	女一口夂
拊	扌亻寸󰁶
氦	󰅎⺄亠人
苊	艹厂⺋󰀅
强	弓口虫󰁶
伺	亻𠃌一口
岛	勹丶ㄅ山
皲	冖车󰅌又
雹	󰀙勹巳󰀅
蛹	虫󰁻用
珂	王丁口󰀝
曹	一ㄇ󰁺日
饔	亠󰁲丿󰀖
萄	艹勹󰅎山
暮	艹日大日
僚	亻大丷小
蹯	口止丿田
碛	石主贝󰁶
胚	月丆卜一
颛	山丆冂贝
懒	忄一口贝
薄	艹氵一寸
慊	忄䒑󰁬󰁗
妓	女十又󰁶
逄	夂󰀂丨辶
毳	丿二乚乚
纸	纟󰁚弋󰁀
隧	阝䒑󰀓辶
惜	忄󰁺日󰀝
嘧	口宀心山
胜	月丿主󰀝
氇	丿二乚日
把	扌巴󰁀
彼	彳󰅌又󰁶
芊	艹丿十󰀬
立	立立立立
御	彳󰅎止卩
时	日寸󰁶
鸷	扌九丶一
稂	禾丶彐󰀖
瓞	⺁厶󰂃人
鹱	勹丶ㄅ又
诃	讠丁口󰀝
艏	丿󰁪䒑目
鸪	古勹丶一
波	氵󰅌又󰁶
氢	󰅎⺄ス工
铍	钅󰅌又󰁶
刺	一冂󰅇刂
悚	忄一口󰅇
缎	纟亻三又
肚	月土󰀝
未	二󰅇󰀦
皱	⺈彐󰅌又
姓	女丿主󰀝
基	艹三八土
撕	扌艹三斤
堪	土艹三󰄃
醒	西一日主
谏	讠一󰀹󰅇
硝	石⺌月󰀝
肜	月彡󰁥
调	讠󰀼土口
策	⺮一冂󰅇
笋	⺮󰁬丿󰁣
逸	⺈口󰁜辶
半	䒑十󰀵
阆	门丶彐󰀖
混	氵日󰁴匕
蘖	艹亻󰁃木
跷	口止弋儿
阶	阝人󰀯󰀢
铺	钅一月丶
铢	钅󰅎󰅇󰁶
倮	亻日木󰁶
柯	木丁口󰀝
被	衤󰁧󰅌又
党	⺌冖口儿
夫	二人󰀦
耕	三󰅇二󰀯
腚	月宀一󰁾
酚	西一八刀
帷	冂丨亻󰁷
岳	󰅍一山󰀬
牒	丿丨一木
枣	一ㄇ󰅇󰁦
滤	氵󰅋七心
绀	纟艹二󰀝
搏	扌一月寸
郜	丿土口阝
娓	女尸丿乚
扒	扌八󰁶
锚	钅艹田󰀝
搂	扌米女󰀝
椹	木艹三󰄃
连	车辶󰀵
腮	月田心󰁶
煮	土丿日灬
即	彐厶卩󰀢
酮	西一冂口
罐	󰅎山艹󰁷
味	口二󰅇󰁶
盘	丿󰁪皿󰀘
镶	钅亠口󰀔
嵛	山人一刂
奘	󰄃丨丆大
迭	󰅎人辶󰀦
嶷	山匕𠂉󰁾
餐	󰀥夕又󰀖
瞬	目爫冖丨
严	一󰅊厂󰁣
娘	女丶彐󰀖
喇	口一口刂
眼	目彐󰀖󰁶
荫	艹阝月󰀘
芝	艹之󰁧
刮	丿古刂󰀢
戮	羽人彡戈
囝	囗子󰀌
曝	日日󰁺氺
邗	干阝󰀢
慎	忄十󰀣八
戒	戈廾󰀵
划	戈刂󰀢
苟	艹勹口󰀘
铂	钅白󰀝
沃	氵丿大󰁶
饧	⺈󰁐ㄋ󰁤
祯	礻󰁶󰀥贝
涛	氵三丿寸
醮	西一亻灬
珊	王󰀼󰀼一
菊	艹勹米󰁧
鏊	主󰁡夂金
糯	米󰀙丆〢
醵	西一󰅋󰀓
絷	扌九丶小
起	土󰁾己󰁫
芪	艹󰁚弋󰀅
海	氵𠂉母󰁶
吴	口一大󰁧
绉	纟⺈彐󰀝
讯	讠⺄十󰀢
糊	米古月󰀝
膈	月一口丨
踟	口止𠂉口
琍	王禾刂󰀢
蝶	虫廿󰄃木
骓	󰀊󰀞亻󰁷
桉	木宀女󰀝
狒	犭ノ弓󰀯
誓	扌斤言󰀘
煦	日勹口灬
拒	扌匚󰁃󰀝
掸	扌丷曰十
俞	人一月刂
郦	一冂丶阝
碹	石宀一一
鬯	󰁘凵匕󰀅
撂	扌田夂口
昏	󰁚弋日󰀘
巛	巛󰁑󰁑󰁑
跛	口止󰅌又
掊	扌立口󰀝
零	󰀙人丶󰁻
诋	讠󰁚󰀁丶
轳	车󰀥尸ノ
竟	立日儿󰀅
咂	口匚冂丨
眶	目匚王󰀝
贷	亻󰀁丶贝
瓶	䒑廾一丶
爵	爫罒彐寸
合	人一口󰀘
懵	忄艹罒目
呈	口王󰀘
凵	凵󰄃丨
抵	扌󰁚󰀁丶
瑕	王󰁃丨又
又	又又又又
攴	󰀥又󰁧
髓	󰀾月辶
芒	艹亠󰄃󰀅
犒	ノ扌󰁸口
抒	扌󰁻乛亅
祧	礻󰁶儿󰀪
灵	彐火󰁧
坝	土贝󰁶
辞	丿古辛󰀢
飧	夕人丶󰀖
倏	亻丨夂犬
髯	󰂞彡冂土
摊	扌又亻󰁷
簋	⺮彐󰀖皿
帛	白冂丨󰀬
告	丿土口󰀘
锶	钅田心󰁶
丛	人人一󰀘
谋	讠艹二木
蕴	艹纟日皿
三	三一一一
收	󰁐丨夂󰁶
丐	一󰀥ㄅ󰁫
嘟	口土丿阝
巧	工一ㄅ󰁀
待	彳土寸󰁶
乘	禾丬匕󰁫
卒	亠人人十
乞	𠂉乙󰀅
獒	󰁡攵犬
荒	艹亠󰄃󰀸
鬓	󰂞彡宀八
争	⺈󰁬亅󰀬
狎	犭ノ甲󰀢
封	土土寸󰁶
亠	亠丶一
狮	犭ノリ丨
拮	扌士口󰀝
砝	石土厶󰁶
潞	氵口止口
稹	禾十󰀣八
锂	钅日土󰀝
猴	犭ノ亻大
鹛	󰁅目勹一
琊	王󰀂亅阝
颧	艹口口贝
吊	口冂丨󰀬
幛	冂丨立早
擀	扌十日干
梯	木丷弓丿
遮	广廿灬辶
屮	凵丨󰀵
嫜	女立早󰀢
作	亻𠂉丨二
狴	犭ノ󰁴土
午	𠂉十󰀬
缰	纟一田一
恶	一󰅊一心
孓	了󰂃󰀦
估	亻古󰀝
俨	亻一󰅊厂
仞	亻刀丶󰁶
掀	扌斤⺈人
嗝	口一口丨
令	人丶󰁻󰁧
价	亻人󰀯󰀢
劈	尸口立刀
掴	扌囗王丶
伦	亻人匕󰁀
猝	犭ノ亠十
狈	犭ノ贝󰁶
怩	忄尸匕󰁀
炸	火𠂉丨二
悸	忄禾子󰀝
壹	士冖一䒑
事	一口󰁬亅
邦	三丿阝󰀢
却	土厶卩󰀢
邸	󰁚󰀁丶阝
裹	亠日木󰀔
挂	扌土土󰀝
炮	火勹巳󰁀
肮	月亠几󰁀
邮	由阝󰀢
涪	氵立口󰀝
蓊	艹八厶羽
鲋	󰁢󰀞亻寸
佝	亻勹口󰀝
桷	木⺈用
宓	宀心丿󰁣
佰	亻丆日󰀝
彰	立早彡󰁥
佞	亻二女󰀝
娣	女丷弓丿
衷	亠口丨󰀔
顷	󰁴丆贝󰁶
襁	衤󰁧弓虫
祁	礻󰁶阝󰀢
愀	忄禾火󰁶
奁	大匚乂󰁧
碥	石丶尸艹
骛	󰁻乛亅一
佳	亻土土󰀝
锫	钅立口󰀝
课	讠日木󰁶
赈	贝厂二󰀖
禹	丿口冂丶
峋	山勹日󰀝
跃	口止丿大
砧	石󰀥口󰀝
址	土止󰀝
喂	口田一󰀖
愉	忄人一刂
恏	女子心󰁧
酪	西一夂口
芥	艹人󰀯󰀬
炷	火丶王󰀝
埝	土人丶心
意	立日心󰁧
钊	钅刂󰀢
寓	宀日冂丶
剀	山󰁁刂󰀢
砷	石日丨󰀢
样	木丷󰅆󰀢
断	米󰄃斤󰀢
莒	艹口口󰀘
篓	⺮米女󰀘
排	扌丨三三
礁	石亻󰁷灬
悦	忄丷口儿
兀	一儿󰁫
椁	木󰁸子󰀝
俜	亻由一ㄅ
坨	土宀匕󰁀
俩	亻一冂人
俪	亻一冂丶
詹	⺈厂八言
穹	宀八弓󰀅
俱	亻󰀣八󰁶
驹	󰀊󰀞勹口
矧	𠂉大弓丨
耦	三󰅇日丶
逦	一冂丶辶
觯	⺈用丷十
啉	口木木󰁶
缜	纟十󰀣八
依	亻亠󰀔󰁶
锉	钅人人土
镊	钅耳又又
篙	⺮󰁸冂口
沂	氵斤󰀢
蕊	艹心心心
尓	𠂉小󰁧
摒	扌尸䒑廾
哉	十戈口󰀌
翰	十早人羽
述	木丶辶󰀦
逶	禾女辶󰀌
仟	亻丿十󰀢
休	亻木󰁶
槁	木󰁸冂口
笛	⺮由󰀘
见	ㄇ󰁜󰀅
私	禾厶󰁶
蒉	艹口丨贝
陂	阝󰅌又󰁶
荚	艹一丷大
然	󰁝犬灬󰁧
吵	口小丿ノ
搵	扌囗人皿
质	⺁十贝󰀦
环	王丆卜󰁶
眚	丿主目󰀘
惶	忄白王󰀝
漶	氵口口心
佛	亻弓󰀯󰀢
遄	山丆冂辶
讧	讠工󰀝
疝	疒山󰀵
淞	氵木八厶
冉	冂土󰀌
堰	土匚日女
够	勹口夕夕
隗	阝白󰁜厶
笸	⺮匚口󰀘
燧	火䒑󰀓辶
冥	冖曰六󰁧
冰	冫水󰁶
眈	目冖󰁜󰁀
蜈	虫口一大
赴	土󰁾卜󰀦
凄	冫一󰁬女
蝈	虫囗王丶
乃	乃ㄋ丿
褊	衤󰁧丶艹
昂	日󰁚卩󰀬
阂	门亠ㄥ人
檀	木亠囗一
县	󰀐一厶󰁧
皈	白⺁又󰁶
糨	米弓口虫
供	亻󰁺八󰁶
候	亻丨ユ大
注	氵丶王󰀝
愧	忄白󰁜厶
称	禾⺈小󰁶
榨	木宀八二
榆	木人一刂
踞	口止尸古
镝	钅亠丷古
歧	止十又󰁶
乙	乙乙〇〇
澍	氵士口寸
辛	辛丶一丨
龛	人一口丶
镖	钅覀二小
绅	纟日丨󰀢
叉	又丶󰀦
揿	扌钅⺈人
桥	木丿大󰀯
卦	土土卜󰁶
痊	疒人王󰀌
趋	土󰁾⺈彐
吾	五口󰀘
溃	氵口丨贝
盂	一󰀛皿󰀘
喜	士口䒑口
电	日乚󰁫
锵	钅丬夕寸
迩	⺈小辶󰀦
溴	氵丿目犬
白	白白白白
唯	口亻󰁷󰀝
铵	钅宀女󰀝
枚	木夂󰁶
垚	土土土󰀘
锯	钅尸古󰀝
讨	讠寸󰁶
甯	宀心用󰀬
支	十又󰁧
缬	纟士口贝
浞	氵口󰁾󰁶
阝	阝󰁋丨
苦	艹古󰀘
进	二󰀯辶󰀵
疵	疒止匕󰁫
械	木戈廾󰀢
周	󰀼土口󰀌
涸	氵囗古󰀝
唿	口勹󰁤心
喊	口厂一丶
耵	耳丁󰀢
丞	了󰀩一󰀘
淋	氵木木󰁶
逵	土八土辶
跋	口止丶
练	纟󰀂𠃌八
暂	车斤日󰀘
瀵	氵米田八
仃	亻丁󰀢
昝	夂卜日󰀘
锿	钅󰁸󰀔󰁶
趸	一󰁡口󰁾
蚂	虫󰀊一󰀝
卯	󰁚丿卩󰀢
擞	扌米女夂
獯	犭ノ丿灬
药	艹纟勹丶
岫	山由󰀝
遵	丷西一辶
念	人丶乛心
吧	口巴󰁀
涞	氵一米󰁶
镒	钅䒑八皿
愎	忄𠂉日夂
衰	亠口一󰀔
仕	亻士󰀝
俦	亻三丿寸
咝	口󰁲󰁲一
憧	忄立日土
下	一卜󰀦
円	冂丨一󰀌
咧	口一夕刂
哟	口纟勹丶
哥	丁口丁口
塔	土艹人口
哐	口匚王󰀝
雉	𠂉大亻󰁷
缃	纟木目󰀝
捉	扌口󰁾󰁶
哧	口土󰁖󰁶
弊	丷冂󰅏廾
伊	亻󰁬丿ノ
唔	口五口󰀝
坂	土⺁又󰁶
卿	󰁚丿彐卩
唤	口⺈ㄇ大
艮	彐󰀖󰀦
啁	口󰀼土口
卵	󰁚丶丿丶
啜	口又又又
芷	艹止󰀘
犷	犭ノ广ノ
攒	扌丿土贝
锒	钅丶彐󰀖
赓	广󰁬人贝
啧	口主贝󰁶
钝	钅一凵乚
啶	口宀一󰁾
牦	ノ扌丿乚
扦	扌丿十󰀢
砚	石ㄇ󰁜󰁀
後	彳幺夂󰁶
之	之之之之
喝	口日勹󰄃
喟	口田月󰀝
鹋	艹田勹一
蹋	口止日羽
瘊	疒亻ユ大
昊	日一大󰁧
蜂	虫夂三丨
偈	亻日勹󰄃
荛	艹弋丿儿
嗄	口丆目夂
佃	亻田󰀝
献	十冂䒑犬
喧	口宀一一
匮	匚口丨贝
芮	艹冂人󰁧
銮	亠󰁗金󰀘
烷	火宀二儿
鲛	󰁢󰀞亠乂
涓	氵口月󰀝
痒	疒丷󰅆󰀵
嗦	口十冖小
嗒	口艹人口
州	丶丿丶丨
唷	口亠厶月
噜	口󰁢一日
巫	工人人󰀦
麋	广󰁃〢米
芦	艹丶尸󰁣
崞	山󰁸子󰀝
洞	氵冂一口
囊	一口丨󰀔
沙	氵小丿ノ
益	䒑八皿󰀘
蛊	虫皿󰀘
嵫	山䒑ㄠㄠ
诸	讠土丿日
寸	寸一亅丶
拿	人一口手
龃	止人凵一
床	广木󰀦
蝉	虫丷曰十
较	车亠八乂
埂	土一日乂
睚	目厂土土
牮	亻弋󰅎丨
扮	扌八刀ノ
囧	囗八ㄇ󰁫
泛	氵丿之󰁶
刷	尸冂丨刂
启	丶尸口󰀌
疒	疒丶一󰀞
户	丶尸󰀏
呶	口女又󰁶
舷	丿󰁪亠ㄠ
囚	囗人󰀦
锝	钅日一寸
坟	土文󰁶
肷	月⺈人󰁶
汞	工水󰁧
属	尸丿口丶
咚	口夂󰁦󰁶
葶	艹󰁸冖丁
滋	氵䒑ㄠㄠ
垢	土⺁一口
蚊	虫文󰁶
搿	人一手
霉	󰀙𠂉母󰁧
垧	土丿冂口
介	人󰀯󰀬
埚	土口冂人
圉	囗土䒑十
有	月󰀘
螂	虫丶彐阝
蜉	虫爫子󰀝
媸	女凵丨虫
心	心丶󰁒丶
促	亻口󰁾󰁶
今	人丶乛󰀅
焉	一止一灬
专	二󰁓丶󰀦
洛	氵夂口󰀝
晒	日西󰀝
埤	土白丿十
饰	⺈󰁐𠂉丨
埯	土大日乚
埴	土十󰀣󰀝
铝	钅口口󰀝
堂	⺌冖口土
堋	土月月󰀝
剃	丷弓丨刂
哝	口冖󰀔󰁶
崛	山尸凵山
秧	禾ㄇ大󰁶
蓝	艹〢𠂉皿
缋	纟口丨贝
堠	土亻ユ大
弋	弋一󰁒丶
堤	土日一󰁾
桂	木土土󰀝
承	了三󰀩󰀦
牿	ノ扌ノ口
艿	艹乃󰁣
嗉	口主ㄠ小
上	上丨一一
塑	䒑凵丿土
塥	土一口丨
仇	亻九󰁀
踊	口止󰁻用
痉	疒ス工󰀌
鲨	氵小丿一
乓	󰅍一丶󰁧
憷	忄木木󰁾
湓	氵八刀皿
冷	冫人丶󰁻
眉	󰁅目󰀌
猊	犭ノ臼儿
壁	尸口立土
壤	土亠口󰀔
薯	艹罒土日
缨	纟贝贝女
蛉	虫人丶󰁻
昆	日󰁴匕󰀅
大	大大大大
头	󰁦大󰀦
斯	艹三八斤
阒	门目犬󰀦
畦	田土土󰀝
涧	氵门日󰀝
厝	厂󰁺日󰀌
恙	丷王心󰁧
砂	石小丿ノ
奖	丬夕大󰁧
郁	月阝󰀢
诞	讠丿止廴
奥	丿ㄇ米大
贸	󰁚丶刀贝
偕	亻󰁴匕白
耶	耳阝󰀢
妙	女小丿ノ
妥	爫女󰀘
酷	西一丿口
篷	⺮夂三辶
库	广车󰀵
姊	女丿ㄅ丿
始	女厶口󰀝
亓	二󰀯󰀬
售	亻󰁷口󰀘
拚	扌厶廾󰀢
姥	女土丿匕
娄	米女󰀘
蟹	⺈用刀虫
偶	亻日冂丶
绨	纟丷弓丿
培	土立口󰀝
嗯	口囗大心
旯	日九󰀅
盒	人一口皿
仨	亻三󰀝
灶	火土󰀝
刖	月刂󰀢
娅	女一󰅊一
娆	女弋丿儿
老	土丿匕󰀅
送	䒑大辶󰀦
赧	土󰁖卩又
鲒	󰁢󰀞士口
葑	艹土土寸
粒	米立󰀝
藿	艹󰀙亻󰁷
阚	门乛耳夂
辋	车冂䒑󰄃
龋	止人凵丶
晚	日⺈口󰁜
娱	女口一大
滓	氵宀辛󰀢
廓	广󰁸孑阝
仓	人⺋󰀅
疚	疒ク󰂃󰀦
炖	火一凵乚
婚	女󰁚弋日
婧	女主月󰀝
亳	󰁸冖丿七
眯	目米󰁶
术	木丶󰀦
圯	土巳󰁀
蔚	艹尸二寸
蟛	虫士口彡
仳	亻󰁴匕󰁀
昶	丶𠃌󰀩日
结	纟士口󰀝
吝	文口󰀘
兖	六厶儿󰀅
紧	〢又ㄠ小
擦	扌宀󰁯小
遁	⺁十目辶
货	亻ヒ贝󰁧
兢	古儿古儿
恁	亻丿士心
媲	女丿囗匕
萑	艹亻󰁷󰀘
峒	山冂一口
媳	女丿目心
冖	冖丶乛
俾	亻白丿十
渲	氵宀一一
嫖	女覀二小
穰	禾亠口󰀔
缓	纟爫一又
具	󰀣八󰁧
鼓	士口䒑又
噶	口艹日󰄃
隶	󰁬氺󰀦
嫫	女艹日大
嫱	女十䒑口
罨	罒大日乚
轨	车九󰁀
镯	钅罒勹虫
哂	口西󰀝
晶	日日日󰀘
嬖	尸口立女
嬛	女罒一󰀔
弓	弓󰁈一ㄅ
奂	⺈ㄇ大󰁧
楂	木木日一
祂	礻󰁶也󰁀
拶	扌巛夕󰁶
菝	艹扌丶
铑	钅土丿匕
浸	氵彐冖又
畿	ㄠㄠ戈田
桊	䒑大木󰁧
长	丿七󰂃󰀦
谒	讠日勹󰄃
瓑	王厂禾止
存	丨子󰀌
骰	󰀾月几又
孟	子皿󰀘
孥	女又子󰀘
项	工丆贝󰁶
匚	匚一󰄃
鲷	󰁢󰀞󰀼口
蜒	虫丿止廴
宄	宀九󰀅
氨	󰅎⺄宀女
钯	钅巴󰁀
谨	讠廿口主
宋	宀木󰁧
完	宀二儿󰀅
儆	亻艹勹夂
宗	宀二小󰁧
定	宀一󰁾󰁧
宝	宀王丶󰁧
当	⺌彐󰀘
体	亻木一󰀝
丸	九丶󰀦
鲧	󰁢󰀞丿小
褂	衤󰁧土卜
常	⺌冖口丨
沧	氵人⺋󰁀
劝	又力ノ
审	宀日丨󰀬
呷	口甲󰀢
曛	日丿一灬
撑	扌⺌冖手
乔	丿大󰀯󰀬
四	四丨󰁈一
蒿	艹󰁸冂口
害	宀三丨口
鑫	金釒金󰀘
钿	钅田󰀝
蟒	虫艹大廾
寨	宀󰀀八木
柒	氵七木󰁧
钶	钅丁口󰀝
诨	讠冖车󰀢
铯	钅⺈巴󰁀
且	󰀐一󰀌
瓯	匚乂一丶
寝	宀丬彐又
寞	宀艹日大
寰	宀罒一󰀔
拷	扌土丿ㄅ
对	又寸󰁶
埒	土爫寸󰁶
尉	尸二小寸
桧	木人二厶
钦	钅⺈人󰁶
观	又ㄇ󰁜󰁀
笞	⺮厶口󰀘
愁	禾火心󰁧
咦	口一弓人
尛	小小小󰁧
粕	米白󰀝
尧	弋丿一儿
磊	石石石󰀘
脉	月丶𠃌󰀩
到	一厶土刂
右	口󰀘
铿	钅〢又土
荑	艹一弓人
岷	山󰁃󰁐弋
蓿	艹宀亻日
鞒	廿󰀜丿󰀯
谷	八人口󰀘
瞒	目艹一人
居	尸古󰀌
廛	广日土土
潸	氵木木月
绛	纟夂󰀂丨
展	尸󰁺󰀖󰀦
黛	亻󰀁丶灬
屡	尸米女󰀌
履	尸彳𠂉夂
纨	纟九丶󰁶
垒	厶厶厶土
刃	刀丶󰀦
亨	󰁸了󰀬
筵	⺮丿止廴
谧	讠心丿皿
簧	⺮󰁺由八
概	木彐厶󰁜
如	女口󰀝
瘿	疒贝贝女
沸	氵弓󰀯󰀢
挝	扌寸辶󰁶
匝	匚冂丨󰀵
犰	犭ノ九󰁀
寒	宀󰀀八󰁦
阿	阝丁口󰀝
酉	西一󰀌
诒	讠厶口󰀝
岔	八刀山󰀬
挑	扌儿󰀪󰁶
光	⺌一儿󰀅
请	讠主月󰀝
岣	山勹口󰀝
岬	山甲󰀢
嗳	口爫冖又
汨	氵日󰀝
缛	纟厂二寸
硒	石西󰀝
弛	弓也󰁀
峤	山丿大󰀯
跄	口止人⺋
峦	亠󰁗山󰀬
瀚	氵十日羽
通	󰁻用辶󰀵
崇	山宀二小
唇	厂二󰀖口
腰	月覀女󰀝
琦	王大丁口
萦	艹冖ㄠ小
幸	土䒑十󰀬
祛	礻󰁶土厶
崧	山木八厶
崮	山囗古󰀘
媞	女曰一󰁾
搦	扌弓冫冫
嵋	山󰁅目󰀝
做	亻古夂󰁶
炉	火丶尸ノ
肉	冂人人󰀦
叶	口十󰀢
悉	丿米心󰁧
嵬	山白󰁜厶
揶	扌耳阝󰀢
靛	主月宀󰁾
坛	土二厶󰁶
邰	厶口阝󰀢
鸶	󰁲󰁲一一
嶝	山癶一䒑
北	丬匕󰁀
偷	亻人一刂
濯	氵羽亻󰁷
巅	山十󰀣贝
俯	亻广亻寸
陛	阝󰁴匕土
工	工工工工
喁	口日冂丶
攫	扌目目又
丶	丶丶〇〇
赂	贝夂口󰀝
枉	木王󰀝
忿	八刀心󰁧
已	已已已已
布	冂丨󰀬
帅	リ冂丨󰀢
哭	口口犬󰁧
栾	亠󰁗木󰁧
砾	石丿󰄃小
坦	土日一󰀝
侧	亻贝刂󰀢
场	土ㄋ󰁤ノ
痛	疒󰁻用󰀵
帚	彐冖冂丨
筒	⺮冂一口
睦	目土八土
憝	󰁸孑攵心
震	󰀙厂二󰀖
帧	冂丨󰀥贝
帮	三丿阝丨
蚵	虫丁口󰀝
蟮	虫丷󰅆口
矮	𠂉大禾女
幔	冂丨日又
幢	冂丨立土
鲂	󰁢󰀞方ノ
貂	豸刀口󰀝
瑁	王曰目󰀝
摁	扌囗大心
冇	冂󰀅
仰	亻󰁚卩󰀢
呛	口人⺋󰁀
瑛	王艹ㄇ大
徊	彳囗口󰀝
骒	󰀊󰀞日木
羊	丷󰅆󰀬
窒	宀八一土
扑	扌卜󰁶
蟾	虫⺈厂言
矾	石几丶󰁶
悛	忄厶八夂
佧	亻上卜󰁶
垦	彐󰀖土󰀘
捷	扌一󰁬󰁾
引	弓丨󰀢
轧	车乚󰁀
酝	西一二厶
慝	匚艹心
稞	禾日木󰁶
弘	弓厶󰁶
闵	门文󰀦
溶	氵宀八口
纶	纟人匕󰁀
弦	弓亠ㄠ󰁶
影	曰󰁸小彡
赐	贝日勹󰁤
弱	弓冫弓冫
萁	艹艹三八
刀	刀𠃌丿
搁	扌门夂口
录	󰁭氺󰁧
难	又亻󰁷󰀝
嗵	口󰁻月辶
玷	王󰀥口󰀝
获	艹犭󰁥犬
俊	亻厶八夂
暾	日󰁸孑攵
栉	木艹ㄗ󰀢
蹿	口止宀丨
嫒	女爫冖又
我	丿扌󰅅丶
彤	󰀼亠彡ノ
僬	亻亻󰁷灬
亮	󰁸冖几󰀅
园	囗二儿󰁫
弧	弓⺁厶󰂃
伧	亻人⺋󰁀
神	礻󰁶日丨
曦	日丷王丶
径	彳ス工󰀝
襞	尸口立󰀔
阵	阝车󰀢
蹶	口止厂人
瘵	疒󰁯二小
昵	日尸匕󰁀
徙	彳止󰁾󰁶
倬	亻󰀥早󰀢
匀	勹冫󰀌
徨	彳白王󰀝
微	彳山一夂
徵	彳山一夂
铁	钅󰅎人󰁶
谂	讠人丶心
并	䒑廾󰀬
笊	⺮⺁丨󰂃
拉	扌立󰀝
勉	⺈口󰁜力
苑	艹夕⺋󰀅
忏	忄丿十󰀢
虾	虫一卜󰁶
百	丆日󰀘
渥	氵尸一土
吁	口一󰀛󰀢
亿	亻乙󰁀
忑	一卜心󰁧
圭	土土󰀘
鳟	󰁢󰀞丷寸
眭	目土土󰀝
凝	冫匕𠂉󰁾
霭	󰀙讠日󰄃
继	纟米󰄃󰁀
忖	忄寸󰁶
黧	禾勹丿灬
志	士心󰁧
遭	一ㄇ󰁺辶
恭	󰁺八⺗󰁧
灭	一火󰀦
鳏	󰁢󰀞罒󰀫
忙	忄亠󰄃󰁀
忠	口丨心󰁧
忡	忄口丨󰀢
求	一氺丶󰀦
璁	王丿囗心
快	忄ユ人󰁶
荭	艹纟工󰀘
凛	冫亠囗小
央	ㄇ大󰀦
态	大丶心󰁧
抉	扌ユ人󰁶
潺	氵尸子子
芑	艹己󰀅
剐	口冂人刂
怙	忄古󰀝
洽	氵人一口
呤	口人丶󰁻
品	口口口󰀘
飞	⺄󰁦󰀦
肝	月干󰀢
炝	火人⺋󰁀
社	礻󰁶土󰀝
座	广人人土
产	立丿󰀏
恽	忄冖车󰀢
拱	扌󰁺八󰁶
花	艹亻ヒ󰀅
剂	文󰀯刂󰀢
肭	月冂人󰁶
炭	山火󰁧
悭	忄〢又土
匐	勹一口田
悄	忄⺌月󰀝
酱	丬夕西一
共	󰁺八󰁧
债	亻主贝󰁶
骊	󰀊󰀞一丶
赭	土󰁖土日
惚	忄勹󰁤心
壮	丬士󰀝
卉	十廾󰀬
草	艹早󰀬
崾	山覀女󰀝
全	人王󰀘
慑	忄耳又又
妒	女丶尸ノ
堃	方方土󰀘
吐	口土󰀝
哼	口󰁸了󰀢
馒	⺈󰁐日又
层	尸二厶󰀦
礞	石艹冖󰀓
例	亻一夕刂
肽	月大丶󰁶
炽	火口八󰁶
冱	冫一󰅂一
愦	忄口丨贝
嗔	口十󰀣八
歌	丁口丁人
家	宀一󰀓󰁧
掾	扌彑󰀓󰁶
怛	忄日一󰀝
吮	口厶儿󰁀
垮	土大二ㄅ
哗	口亻ヒ十
猁	犭ノ禾刂
软	车⺈人󰁶
瘗	疒一丷土
灿	火山󰀢
尚	⺌冂口󰀘
佯	亻丷󰅆󰀢
丢	丿土厶󰁧
按	扌宀女󰀝
盔	火皿󰀘
讶	讠󰀂亅丿
蛔	虫囗口󰀝
秒	禾小丿ノ
使	亻一口乂
姒	女󰁐丶人
惰	忄工月
胰	月一弓人
轿	车丿大󰀯
齿	止人凵󰀬
殂	一夕󰀐一
十	十一丨
倚	亻大丁口
痦	疒五口󰀌
埽	土彐冖丨
伲	亻尸匕󰁀
丧	十䒑󰀖󰁧
戴	十戈田八
廴	廴󰁌󰂃
逭	宀丨󰁃辶
郭	󰁸孑阝󰀢
岜	山巴󰀅
菁	艹主月󰀘
倭	亻禾女󰀝
蝮	虫𠂉日夂
羯	䒑󰀠日󰄃
釉	丿米由󰀝
保	亻口木󰁶
侯	亻ユ𠂉大
樊	木乂乂大
些	止匕二󰀘
錵	釒艹亻ヒ
茵	艹囗大󰁧
唰	口尸冂刂
凑	冫三人大
咔	口上卜󰁶
曰	日丨󰁈一
懑	氵艹一心
郝	土󰁖阝󰀢
褒	亠亻口󰀔
翠	羽亠人十
耽	耳冖󰁜󰁀
增	土丷󰀺日
惝	忄⺌冂口
瘦	疒臼丨又
胝	月󰁚󰀁丶
夂	夂丿乛󰂃
困	囗木󰀦
尬	乚人󰀯
新	立木斤󰀢
六	六丶一丶
也	也𠃌丨乚
忧	忄乚丶
湟	氵白王󰀝
据	扌尸古󰀝
呔	口大丶󰁶
魂	二厶白厶
琰	王火火󰁶
蕨	艹厂䒑人
孱	尸子孑子
徼	彳白方夂
实	宀󰁦大󰁧
砦	止匕石󰀘
蹟	口止貝
遥	爫󰅎山辶
腭	月口口ㄅ
眠	目󰁃󰁐弋
钰	钅王丶󰁶
刑	一廾刂󰀢
撰	扌巳巳八
膑	月宀󰅍八
醑	西一乛月
嵇	禾乚山
瑰	王白󰁜厶
樾	木土󰁾丶
喉	口亻ユ大
恵	一由心󰁧
兽	丷田一口
迷	米辶󰀦
鹊	󰁺日勹一
腽	月日皿󰀝
酽	西一一厂
亟	了口又一
搔	扌又丶虫
溟	氵冖曰六
傥	亻⺌冖儿
晕	日冖车󰀬
嘿	口󰀹土灬
允	厶儿󰀅
卑	白丿十󰀬
岂	山己󰀅
金	金金金金
咿	口亻󰁬丿
逐	一󰀓辶󰀦
耐	丆冂〢寸
癞	疒一口贝
桑	又又又木
韦	二𠃌丨󰀵
菱	艹土八夂
蚕	一大虫󰁧
摞	扌田ㄠ小
哑	口一󰅊一
冁	丷曰十󰀖
摧	扌山亻󰁷
颞	耳又又贝
弟	丷弓丨丿
菔	艹月卩又
撞	扌立日土
冽	冫一夕刂
荡	艹氵ㄋ󰁤
邵	刀口阝󰀢
剿	巛日木刂
陉	阝ス工󰀝
越	土󰁾一丶
惭	忄车斤󰀢
梦	木木夕󰁧
胭	月囗大󰁶
髂	󰀾月宀口
勿	勹󰁤󰀏
铕	钅月󰀝
振	扌厂二󰀖
只	口八󰁧
锕	钅阝丁口
塬	土厂白小
遐	󰁃丨二辶
噙	口人亠厶
黟	󰀹土灬夕
攥	扌⺮目小
堑	车斤土󰀘
僭	亻󰀂󰁜日
己	己󰁈一乚
丙	一冂人󰀦
炔	火ユ人󰁶
燥	火口口木
叹	口又󰁶
倔	亻尸凵山
比	󰁴匕󰁀
敦	󰁸孑攵󰁶
碾	石尸󰁺󰀖
能	厶月匕匕
都	土丿日阝
嘉	士口䒑〇
昕	日斤󰀢
扁	丶尸冂艹
剁	几木刂󰀢
阉	门大日乚
确	石⺈用
苁	艹人人󰁧
伟	亻二𠃌丨
衮	六厶󰀔󰁧
妾	立女󰀘
斤	斤丿丿丨
斥	斤丶󰀦
斫	石斤󰀢
喋	口廿󰄃木
飑	几乂勹巳
旦	日一󰀘
肱	月厶󰁶
炱	厶口火󰁧
壑	󰀥冖一土
蛞	虫丿古󰀝
缟	纟󰁸冂口
唢	口⺌贝󰁶
邈	豸白儿辶
裉	衤󰁧彐󰀖
磉	石又又木
棉	木白冂丨
傈	亻覀木󰁶
囖	口⺮罒󰁷
春	三人日󰀘
衾	人丶乛󰀔
桶	木󰁻用
典	ㄇ󰁺八󰁧
顾	厂⺋丆贝
是	日一󰁾󰁧
噢	口丿ㄇ大
顶	丁丆贝󰁶
塾	󰁸孑九土
寂	宀上小又
冒	曰目󰀘
晌	日丿冂口
厂	厂一丿
佟	亻夂󰁦󰁶
艽	艹九󰀅
剽	覀二小刂
款	士二小人
郐	人二厶阝
酥	西一禾󰁶
囹	囗人丶󰁻
虱	⺄丿虫󰀦
昱	日立󰀘
暄	日宀一一
碑	石白丿十
盱	目一󰀛󰀢
颉	士口丆贝
囱	丿囗夕󰀦
碉	石󰀼土口
姘	女䒑廾󰀢
墉	土广󰁬丨
忝	一大⺗󰁧
蚱	虫𠂉丨二
侣	亻口口󰀝
柢	木󰁚󰀁丶
矢	𠂉大󰁧
焕	火⺈ㄇ大
刂	刂丨亅
俣	亻口一大
钕	钅女󰀝
狁	犭ノ厶儿
朐	月勹口󰀝
嗱	口人一手
屐	尸彳十又
旱	日干󰀬
朦	月艹冖󰀓
芽	艹󰀂亅丿
喵	口艹田󰀝
抽	扌由󰀝
思	田心󰁧
逝	扌斤辶󰀵
辟	尸口辛󰀢
睑	目人一一
村	木寸󰁶
葱	艹勹󰁤心
李	木子󰀘
棂	木彐火󰁶
呱	口⺁厶󰂃
在	丨土󰀌
祉	礻󰁶止󰀝
杖	木󰂃󰁶
凼	水凵󰀵
杞	木己󰁀
晤	日五口󰀝
愈	人一月心
奉	三人󰀟󰀬
铱	钅亠󰀔󰁶
杲	日木󰁧
婵	女丷曰十
韶	立日刀口
夼	大川󰀬
劁	亻󰁷灬刂
析	木斤󰀢
犁	禾刂󰅎丨
祀	礻󰁶巳󰁀
局	尸𠃌口󰀌
妮	女尸匕󰁀
鄢	一止一阝
相	木目󰀝
翟	羽亻󰁷󰀘
俟	亻厶𠂉大
堞	土廿󰄃木
觜	止匕⺈用
匕	匕丿乚
胥	乛󰁾月󰀘
枝	木十又󰁶
枞	木人人󰁶
臭	丿目犬󰁧
嗓	口又又木
枧	木ㄇ󰁜󰁀
熊	厶月匕灬
腈	月主月󰀝
馘	䒑丿目󰀞
柠	木宀丁󰀢
徒	彳土󰁾󰁶
司	𠃌一口󰀌
先	丿土儿󰀅
慈	䒑ㄠㄠ心
轭	车厂⺋󰁀
函	了󰀪凵󰀵
螽	夂󰁦虫虫
禾	禾禾禾禾
潭	氵覀早󰀢
馀	⺈󰁐人木
受	爫冖又󰁧
柜	木匚󰁃󰀝
肇	丶尸夂󰀟
柞	木𠂉丨二
楮	木土丿日
刭	ス工刂󰀢
赶	土󰁾干󰀵
楦	木宀一一
攵	攵丿一󰂃
辽	了辶󰀵
缒	纟亻󰁃辶
柑	木艹二󰀝
烟	火囗大󰁶
襦	衤󰁧󰀙〢
舭	丿󰁪󰁴匕
惟	忄亻󰁷󰀝
柿	木亠冂丨
饮	⺈󰁐⺈人
睥	目白丿十
瘠	疒󰀪人月
雨	雨一丨丶
栋	木󰀂小󰁶
哨	口⺌月󰀝
忒	弋心丶󰀦
栓	木人王󰀝
靠	丿土口三
刽	人二厶刂
碜	石厶大彡
爽	大乂乂乂
戽	丶尸󰁦十
栖	木西󰀝
栝	木丿古󰀝
遇	日冂丨辶
阳	阝日󰀝
钞	钅小丿ノ
换	扌⺈ㄇ大
莉	艹禾刂󰀬
瘳	疒羽人彡
剥	󰁭氺刂󰀢
江	氵工󰀝
璞	王󰅊一人
矸	石干󰀢
裔	亠󰀔冂口
瞑	目冖曰六
挢	扌丿大󰀯
鞑	廿󰀜大辶
惘	忄冂䒑󰄃
桅	木⺈厂⺋
框	木匚王󰀝
跨	口止大ㄅ
刿	山夕刂󰀢
吓	口一卜󰁶
矬	𠂉大人土
鳄	󰁢󰀞口ㄅ
馁	⺈󰁐爫女
桠	木一󰅊一
手	手丿一亅
悼	忄󰀥早󰀢
净	冫⺈󰁬亅
卮	⺁一⺋󰁫
荮	艹纟寸󰁧
臀	尸󰁺八月
珉	王󰁃󰁐弋
揉	扌󰁻乛木
尊	丷西一寸
桨	丬夕木󰁧
尼	尸匕󰁫
鲟	󰁢󰀞彐寸
缥	纟覀二小
桫	木氵小丿
报	扌卩又󰁶
孽	艹亻󰁃子
触	⺈用虫󰁶
粟	覀米󰁧
宴	宀日女󰀘
漆	氵木人氺
狩	犭ノ宀寸
怯	忄土厶󰁶
梁	氵刀八木
悯	忄门文󰁶
镆	钅艹日大
邕	巛口巴󰀅
濞	氵丿目󰀯
擢	扌羽亻󰁷
俗	亻八人口
恕	女口心󰁧
坷	土丁口󰀝
杷	木巴󰁀
梭	木厶八夂
归	リ彐󰀝
莼	艹纟一乚
掮	扌丶尸月
玮	王二𠃌丨
坭	土尸匕󰁀
汊	氵又丶󰁶
玉	王丶󰀦
崆	山宀八工
届	尸由󰀌
诊	讠人彡ノ
疖	疒ㄗ󰀵
锞	钅日木󰁶
迁	丿十辶󰀵
窦	宀八十大
棚	木月月󰀝
绒	纟戈ノ
攞	扌罒糹󰁷
袷	衤󰁧人口
畎	田犬󰁶
棠	⺌冖口木
盖	丷王皿󰀘
撺	扌宀八丨
森	木木木󰁧
檠	艹勹口木
漩	氵方𠂉󰁾
蜷	虫䒑大⺋
眷	䒑大目󰀘
棵	木日木󰁶
押	扌甲󰀢
棹	木󰀥早󰀢
潆	氵艹冖小
椅	木大丁口
缤	纟宀󰅍八
哮	口土丿子
猫	犭ノ艹田
互	一󰅂一󰀌
贞	󰀥贝󰁧
拼	扌䒑廾󰀢
贯	󰅂十贝󰁧
累	田ㄠ小󰁧
隈	阝田一󰀖
椰	木耳阝󰀢
呃	口厂⺋󰁀
或	戈口󰀞󰀌
铞	钅口冂丨
负	⺈贝󰁧
监	〢𠂉丶皿
戥	日丿主戈
哞	口厶󰅎丨
驮	󰀊󰀞大󰁶
茭	艹亠八乂
楠	木十冂十
冼	冫丿土儿
壬	丿士󰀌
咀	口󰀐一󰀝
楫	木口耳󰀝
汁	氵十󰀢
楷	木󰁴匕白
佗	亻宀匕󰁀
雷	󰀙田󰀘
渣	氵木日一
怼	又寸心󰁧
宀	宀丶丶乛
值	亻十󰀣󰀝
曷	日勹人󰄃
廒	广主󰁡夂
峯	山夂三丨
傀	亻白󰁜厶
矣	厶𠂉大󰁧
磁	石䒑ㄠㄠ
吉	士口󰀘
竽	⺮一󰀛󰀬
裁	十戈亠󰀔
盈	乃又皿󰀘
符	⺮亻寸󰁧
荥	艹冖水󰁧
曈	日立曰土
皑	白山己󰁀
蹒	口止艹人
锃	钅口王󰀝
向	丿冂口󰀌
沽	氵古󰀝
岽	山󰀂小󰁧
榘	𠂉大匚木
肼	月二󰀯󰀢
慧	三丨三心
蹰	口止厂寸
礤	石艹󰁯小
恩	囗大心󰁧
榫	木亻󰁷十
铳	钅亠厶儿
遢	日羽辶󰀌
菖	艹日日󰀘
鲩	󰁢󰀞宀儿
鲽	󰁢󰀞廿木
肿	月口丨󰀢
粽	米宀二小
椠	车斤木󰁧
糟	米一ㄇ日
璋	王立早󰀢
墁	土日罒又
骷	󰀾月古󰀝
霈	󰀙氵一丨
袁	土口󰀔󰁧
颁	八刀丆贝
竦	立一口󰅇
接	扌立女󰀝
镞	钅方𠂉大
蕞	艹日耳又
仉	亻几󰁀
轰	车又又󰁧
朽	木一ㄅ󰁀
妗	女人丶乛
慢	忄日罒又
撼	扌厂一心
槟	木宀󰅍八
衿	衤󰁧人乛
卓	󰀥早󰀬
蝽	虫三人日
厥	厂䒑凵人
邢	一廾阝󰀢
辩	辛讠辛󰀢
章	立早󰀬
辂	车夂口󰀝
睁	目⺈󰁬亅
钼	钅目󰀝
徂	彳󰀐一󰀝
籽	米子󰀝
套	大󰂞󰁧
隘	阝䒑八皿
婷	女󰁸冖丁
啃	口止月󰀝
暑	日土丿日
臣	匚丨󰁃丨
驷	󰀊󰀞四󰀝
翱	白大十羽
状	丬犬󰁶
若	艹口󰀘
杈	木又丶󰁶
拥	扌用󰀢
箦	⺮主贝󰁧
性	忄丿主󰀝
樘	木⺌冖土
尽	尸󰂃󰁦󰁧
伉	亻亠几󰁀
玳	王亻󰀁丶
樟	木立早󰀢
趴	口止八󰁶
谡	讠田八夂
嚼	口爫罒寸
宦	宀匚丨丨
赞	丿土儿贝
骨	󰀾月󰀘
霁	󰀙文󰀯󰀬
樯	木十䒑口
省	小丿目󰀘
迂	一󰀛辶󰀵
樵	木亻󰁷灬
濂	氵广䒑󰁗
柏	木白󰀝
铬	钅夂口󰀝
谯	讠亻󰁷灬
氽	人水󰁧
氯	󰅎⺄󰁭氺
叮	口丁󰀢
稷	禾田八夂
救	一氺丶夂
蝰	虫大土土
恧	丆冂〢心
月	月月月月
警	艹勹口言
猥	犭ノ田󰀖
挥	扌冖车󰀢
旃	方𠂉󰀼亠
政	一止夂󰁶
犸	犭ノ󰀊一
吼	口孑乚󰁀
河	氵丁口󰀝
橹	木󰁢一日
诤	讠⺈󰁬亅
渐	氵车斤󰀢
学	󰀧冖子󰀘
馇	⺈󰁐木一
鉴	〢𠂉丶金
稠	禾󰀼土口
趔	土󰁾一刂
缂	纟廿󰀜󰀢
第	⺮弓丨丿
沈	氵冖󰁜󰁀
檎	木人亠厶
副	一口田刂
柁	木宀匕󰁀
异	巳廾󰀬
琮	王宀二小
误	讠口一大
萼	艹口口ㄅ
制	󰅎冂丨刂
汜	氵巳󰁀
父	八乂󰁧
舶	丿󰁪白󰀝
唑	口人人土
蝓	虫人一刂
鳝	󰁢󰀞䒑口
檬	木艹冖󰀓
沓	水日󰀘
擗	扌尸口辛
呵	口丁口󰀝
选	丿土儿辶
倨	亻尸古󰀝
葵	艹癶一大
醉	西一亠十
暗	日立日󰀝
好	女子󰀝
贿	贝月󰀝
疗	疒了󰀵
啼	口亠丷丨
蔓	艹日罒又
罂	贝贝󰅎山
茧	艹虫󰁧
欠	⺈人󰁧
欢	又⺈人󰁶
凉	冫󰁸小󰁶
欤	一ㄅ󰀞人
涯	氵厂土土
啮	口止人凵
簦	⺮癶一䒑
谦	讠䒑󰁬󰁗
榷	木冖亻󰁷
其	艹三八󰁧
嗑	口土厶皿
赝	厂亻亻贝
办	力八󰀦
洒	氵西󰀝
瘘	疒米女󰀌
嵝	山米女󰀝
正	一止󰀌
澧	氵ㄇ󰁺䒑
懦	忄󰀙丆〢
皇	白王󰀘
隋	阝工月
撵	扌二人车
钵	钅木一󰀝
诶	讠厶𠂉大
馊	⺈󰁐臼又
艉	丿󰁪尸乚
於	方人󰁦󰁶
疼	疒夂󰁦󰀦
赏	⺌冖口贝
笠	⺮立󰀘
纂	⺮目大小
薮	艹米女夂
殆	一夕厶口
殇	一夕𠂉󰁤
鹈	丷弓丨一
婊	女主󰀔󰁶
饷	⺈󰁐丿口
浯	氵五口󰀝
祷	礻󰁶三寸
窟	宀八尸山
冶	冫厶口󰀝
钥	钅月󰀝
殑	一夕古儿
喑	口立日󰀝
斑	王文王󰀝
疑	匕𠂉大󰁾
殒	一夕口贝
谑	讠󰅋七一
呐	口冂人󰁶
民	󰁃󰁐弋󰁫
殡	一夕宀八
钧	钅勹冫󰀝
葭	艹󰁃丨又
叵	匚口󰀌
槊	䒑凵丿木
萜	艹冂丨口
觊	山󰁁ㄇ󰁜
崽	山田心󰁧
钬	钅火󰁶
穿	宀八󰀂丿
芾	艹一冂丨
毂	士冖车又
缯	纟丷󰀺日
绂	纟又丶
弯	亠󰁗弓󰀅
伯	亻白󰀝
蓼	艹羽人彡
鳔	󰁢󰀞覀小
妊	女丿士󰀝
阁	门夂口󰀌
鲦	󰁢󰀞夂木
夷	一弓人󰀦
猞	犭ノ人口
菥	艹木斤󰀬
句	勹口󰀌
钐	钅彡ノ
毖	󰁴匕心丿
涔	氵山人乛
块	土ユ人󰁶
琐	王⺌贝󰁶
搐	扌亠ㄠ田
屑	尸⺌月󰀌
琵	王王󰁴匕
铉	钅亠ㄠ󰁶
蓉	艹宀八口
紊	文ㄠ小󰁧
林	木木󰁶
谭	讠覀早󰀢
唼	口立女󰀝
泽	氵又二丨
认	讠人󰁶
镘	钅日罒又
贝	贝丨󰁈丶
氏	󰁚弋󰁫
市	亠冂丨󰀬
绯	纟丨三三
氓	亠󰄃󰁃弋
圮	土己󰁀
雁	厂亻亻󰁷
蔼	艹讠日󰄃
蜮	虫戈口󰀞
黯	󰀹土灬日
星	日丿主󰀘
鬟	󰂞彡罒󰀔
营	艹冖口口
狞	犭ノ宀丁
永	丶𠃌󰀩󰀦
屦	尸彳米女
遣	口丨一辶
浙	氵扌斤󰀢
岑	山人丶乛
擐	扌罒一󰀔
粑	米巴󰁀
蓐	艹厂二寸
钉	钅丁󰀢
剧	尸古刂󰀢
执	扌九丶󰁶
赊	贝人二小
汆	丿󰂃水󰁧
汇	氵匚󰁀
绋	纟弓󰀯󰀢
等	⺮土寸󰁧
汕	氵山󰀢
侄	亻一厶土
霾	󰀙豸日土
裕	衤󰁧八口
绿	纟󰁭氺󰁶
蜾	虫日木󰁶
廿	廿一丨一
宙	宀由󰀘
蹂	口止󰁻木
鹂	一冂丶一
荜	艹󰁴匕十
水	水水水水
画	一田凵󰀬
崦	山大日乚
污	氵二ㄅ󰁀
略	田夂口󰀝
莞	艹宀二儿
镥	钅󰁢一日
蜱	虫白丿十
闾	门口口󰀌
坼	土斤丶󰁶
咐	口亻寸󰁶
汽	氵󰅎⺄󰁀
璐	王口止口
蕉	艹亻󰁷灬
蹀	口止廿木
莘	艹辛󰀬
镉	钅一口丨
毙	󰁴匕一匕
坫	土󰀥口󰀝
沅	氵二儿󰁀
镁	钅丷王大
沐	氵木󰁶
说	讠丷口儿
涂	氵人一木
嶂	山立早󰀢
蛾	虫丿扌丶
盾	⺁十目󰀌
曾	丷󰀺日󰀘
图	囗夂󰁦󰀦
崭	山车斤󰀬
沟	氵勹厶󰁶
昭	日刀口󰀝
菜	艹爫木󰁧
卞	亠卜󰁧
浊	氵虫󰁶
疥	疒人󰀯󰀵
屯	一凵乚󰁫
鲑	󰁢󰀞土土
荞	艹丿大󰀯
购	贝勹厶󰁶
钮	钅󰁈丨二
魜	󰁢灬人󰁶
沦	氵人匕󰁀
胩	月上卜󰁶
词	讠𠃌一口
荐	艹丨子
钻	钅󰀥口󰀝
捐	扌口月󰀝
獐	犭󰁥立早
油	氵由󰀝
埋	土日土󰀝
锁	钅⺌贝󰁶
罩	罒󰀥早󰀬
帽	冂丨曰目
丽	一冂丶丶
唁	口言󰀝
囫	囗勹󰁤󰀏
闼	门大辶󰀦
踽	口止丿丶
踯	口止䒑阝
旭	九日󰀌
旮	九日󰀘
怠	厶口心󰁧
蹊	口止爫大
胤	丿ㄠ月乚
搞	扌󰁸冂口
綦	艹三八小
敉	米夂󰁶
察	宀󰁯二小
泓	氵弓厶󰁶
法	氵土厶󰁶
蓥	艹冖金󰀘
铥	钅丿土厶
孑	孑乛亅󰀞
宣	宀一日一
粿	米曰木󰁶
谊	讠宀󰀐一
魑	白󰁜厶厶
娃	女土土󰀝
筑	⺮工几丶
稃	禾爫子󰀝
仁	亻二󰀝
懂	忄艹丿土
苘	艹冂口󰀘
泞	氵宀丁󰀢
旁	亠丷冖方
巽	巳巳󰁺八
昼	尸󰂃日一
瘼	疒艹日大
跽	口止己心
阼	阝𠂉丨二
蛀	虫丶王󰀝
路	口止夂口
巯	ス工亠󰀸
汶	氵文󰁶
黩	󰀹土灬大
泶	󰀧冖水󰁧
珞	王夂口󰀝
揞	扌立曰󰀝
唉	口厶𠂉大
泊	氵白󰀝
黄	󰁺由八󰁧
站	立󰀥口󰀝
锥	钅亻󰁷󰀝
谟	讠艹日大
修	亻丨夂彡
捏	扌日土󰀝
泸	氵󰀥尸ノ
馓	⺈󰁐󰁺夂
提	扌日一󰁾
珐	王土厶󰁶
庵	广大日乚
亵	亠扌九󰀔
澉	氵乛耳夂
腠	月三人大
侉	亻大二ㄅ
徉	彳丷󰅆󰀢
鸦	󰀂亅丿一
髌	󰀾月宀八
辉	⺌一儿车
龉	止人凵口
带	一〣冖丨
旬	勹日󰀌
嗬	口艹亻口
惴	忄山丆〢
让	讠上󰀝
拜	三十󰀢
盲	亠󰄃目󰀘
趁	土󰁾人彡
纵	纟人人󰁶
晴	日主月󰀝
陴	阝白丿十
伸	亻日丨󰀢
瞿	目目亻󰁷
翮	一口冂羽
枭	勹丶ㄅ木
忮	忄十又󰁶
蠓	虫艹冖󰀓
洧	氵月󰀝
芜	艹二󰁜󰀅
龆	止人凵口
篑	⺮口丨贝
掐	扌⺈臼󰀝
髹	󰂞彡亻木
译	讠又二丨
洳	氵女口󰀝
濉	氵目亻󰁷
忉	忄刀ノ
蟀	虫亠ㄠ十
揍	扌三人大
颟	艹一冂贝
反	⺁又󰀦
螈	虫厂白小
淦	氵金󰀝
左	工󰀘
煜	火日立󰀝
灞	氵󰀙廿月
渠	氵匚󰁃木
喀	口宀夂口
诹	讠耳又󰁶
锊	钅爫寸󰁶
暴	日󰁺八氺
皴	厶八夂又
蚴	虫ㄠ力ノ
膝	月木人氺
板	木⺁又󰁶
睿	󰀥冖一目
轸	车人彡ノ
杭	木亠几󰁀
弭	弓耳󰀝
浒	氵讠𠂉十
缭	纟大丷小
漭	氵艹大廾
浓	氵冖󰀔󰁶
旧	丨日󰀝
敫	白方夂󰁶
拂	扌弓󰀯󰀢
姹	女宀丿七
偏	亻丶尸艹
案	宀女木󰁧
灏	氵日亠贝
娑	氵小丿女
遏	日勹人辶
麦	主夂󰁧
浚	氵厶八夂
谁	讠亻󰁷󰀝
脞	月人人土
嗥	口白大十
日	日日日日
椿	木三人日
亦	亠󰁖󰁧
蹭	口止丷日
桎	木一厶土
间	门日󰀌
踵	口止丿土
痴	疒𠂉大口
觋	工人人󰁜
吆	口ㄠ󰁶
呀	口󰀂亅丿
程	禾口王󰀝
理	王日土󰀝
节	艹ㄗ󰀬
圬	土二ㄅ󰁀
本	木一󰀌
续	纟十乛大
蝾	虫艹冖木
嘴	口止匕用
猬	犭ノ田月
涙	氵丶尸大
醇	西一亠子
眦	目止匕󰁀
舐	丿古󰁚弋
穑	禾十䒑口
成	厂𠃌󰅅丶
涟	氵车辶󰁶
削	⺌月刂󰀢
鹦	贝贝女一
胞	月勹巳󰁀
豁	宀三丨口
椟	木十乛大
脾	月白丿十
书	󰁈𠃌丨丶
迟	尸󰂃辶󰀦
涨	氵弓丿󰂃
谗	讠⺈口󰁦
践	口止戋
阴	阝月󰀝
昴	日󰁚丿卩
瘴	疒立早󰀵
屁	尸󰁴匕󰁫
停	亻󰁸冖丁
烘	火󰁺八󰁶
闽	门虫󰀦
霍	󰀙亻󰁷󰀘
寮	宀大丷小
掭	扌一大⺗
挞	扌大辶󰁶
偬	亻勹󰁤心
幻	ㄠ𠃌󰁀
腥	月日丿主
倜	亻󰀼土口
狐	犭ノ⺁󰂃
陧	阝日土󰀝
段	亻三几又
宵	宀⺌月󰀘
肘	月寸󰁶
爬	⺁丨󰂃巴
勐	子皿力ノ
檑	木󰀙田󰀝
沁	氵心󰁶
络	纟夂口󰀝
鋈	氵丿大金
鲁	󰁢一日󰀘
讵	讠匚󰁃󰀝
缦	纟日罒又
襟	衤󰁧木小
拈	扌󰀥口󰀝
帻	冂丨主贝
袭	ヒ丶󰀔
灬	灬丶丶丶
皿	皿丨󰁈一
谱	讠䒑󰅊日
额	宀夂口贝
髋	󰀾月宀󰁜
岁	山夕󰁧
锆	钅丿土口
闺	门土土󰀌
旎	方𠂉尸匕
唆	口厶八夂
垫	扌九丶土
催	亻山亻󰁷
渊	氵丿米丨
卩	卩𠃌丨
炜	火二𠃌丨
叫	口󰁐丨󰀢
孵	󰁚丶丿子
髑	󰀾月罒虫
捩	扌丶尸犬
耸	人人耳󰀘
哆	口夕夕󰁶
劐	艹亻󰁷刂
糁	米厶大彡
温	氵日皿󰀝
褛	衤󰁧米女
港	氵󰁺八巳
煞	⺈彐夂灬
滦	氵亠󰁗木
酞	西一大丶
嫉	女疒𠂉大
螟	虫冖曰六
邬	勹ㄅ󰀞阝
悬	󰀐一厶心
硭	石艹亠󰄃
所	⺁󰁃斤󰀢
游	氵方𠂉子
峁	山󰁚丿卩
龠	人一口艹
蝎	虫日勹󰄃
煸	火丶尸艹
酸	西一厶夂
彗	三丨三彐
贳	廿󰄃贝󰁧
镲	钅宀󰁯小
湃	氵三十
熬	主󰁡夂灬
拴	扌人王󰀝
蛴	虫文󰀯󰀢
冬	夂󰁦󰁧
児	丨日儿󰀅
湘	氵木目󰀝
擂	扌󰀙田󰀝
腐	广亻寸人
酐	西一干󰀢
侦	亻󰀥贝󰁶
捆	扌囗木󰁶
饽	⺈󰁐十子
酬	西一丶丨
嬉	女士口口
滘	氵冖八口
苴	艹󰀐一󰀘
租	禾󰀐一󰀝
庸	广󰁬用
颂	八厶丆贝
湫	氵禾火󰁶
湮	氵覀土󰀝
潮	氵十日月
砭	石丿之󰁶
轮	车人匕󰁀
荀	艹勹日󰀘
啲	口白勹丶
湿	氵日󰅊一
苒	艹冂土󰀘
侮	亻𠂉母󰁶
鳃	󰁢󰀞田心
铲	钅立丿ノ
郸	丷曰十阝
炬	火匚󰁃󰀝
焐	火五口󰀝
莴	艹口冂人
契	三丨刀大
璀	王山亻󰁷
源	氵厂白小
哀	󰁸󰀔󰁧
恬	忄丿古󰀝
脐	月文󰀯󰀢
娟	女口月󰀝
魉	白󰁜厶人
霎	󰀙立女󰀘
铀	钅由󰀝
挈	三丨刀手
蜥	虫木斤󰀢
茈	艹止匕󰀅
茴	艹囗口󰀘
韭	三〢三一
倾	亻󰁴丆贝
镂	钅米女󰀝
傩	亻又亻󰁷
埭	土󰁬氺󰁶
魁	白󰁜厶十
短	𠂉大一䒑
绸	纟󰀼土口
稣	󰁢󰀞禾󰁶
准	冫亻󰁷󰀝
溧	氵覀木󰁶
梵	木木几丶
遴	米夕󰀂辶
臆	月立日心
涉	氵止󰀤ノ
痈	疒用󰀵
榭	木丿󰀽寸
公	八厶󰁧
恤	忄丿皿󰀝
嚟	口禾勹氺
堙	土覀土󰀝
馑	⺈󰁐廿主
烦	火丆贝󰁶
碧	王白石󰀘
写	冖一ㄅ一
钡	钅贝󰁶
宁	宀丁󰀬
殁	一夕几又
酾	西一一丶
翦	䒑月刂羽
滠	氵耳又又
颥	󰀙丆冂贝
翥	土丿日羽
匦	匚车九󰁫
滨	氵宀󰅍八
爪	⺁丨󰂃󰀦
珀	王白󰀝
菀	艹宀夕⺋
截	十戈亻󰁷
静	主月⺈亅
喈	口󰁴匕白
莲	艹车辶󰁧
悴	忄亠人十
漂	氵覀二小
肴	乂月󰀘
页	丆贝󰁧
弃	亠厶廾󰀬
褥	衤󰁧厂寸
姑	女古󰀝
憬	忄日亠小
科	禾󰁦十󰀢
槑	口木口木
醐	西一古月
觑	󰅋七󰅊󰁜
辏	车三人大
皙	木斤白󰀘
剪	䒑月刂刀
霖	󰀙木木󰁧
憾	忄厂一心
撮	扌日耳又
西	西一丨一
补	衤󰁧卜󰁶
祭	󰁯二小󰁧
偻	亻米女󰀝
恻	忄贝刂󰀢
漪	氵犭ノ口
漫	氵日罒又
鳋	󰁢󰀞又虫
证	讠一止󰀝
篁	⺮白王󰀘
暁	日十艹儿
总	丷口心󰁧
华	亻ヒ十󰀬
辰	厂二󰀖󰀦
堵	土土丿日
镫	钅癶一䒑
啊	口阝丁口
韧	二𠃌丨丶
夭	丿大󰀦
陈	阝󰀂小󰁶
期	艹三八月
土	土土土土
蛮	亠󰁗虫󰁧
挺	扌丿士廴
谓	讠田月󰀝
潦	氵大丷小
拾	扌人一口
勾	勹厶󰀦
疮	疒人⺋󰁫
七	七一乚
朝	十早月󰀝
绚	纟勹日󰀝
硐	石冂一口
屏	尸䒑廾󰀵
辘	车广󰁃匕
真	十󰀣八󰁧
烬	火尸󰂃󰁦
椭	木阝月
妆	丬女󰀝
胬	女又冂人
馆	⺈󰁐宀󰁃
鹃	口月勹一
植	木十󰀣󰀝
冻	冫󰀂小󰁶
澳	氵丿ㄇ大
胀	月丿七󰂃
嘈	口一ㄇ日
义	丶乂󰀦
炀	火ㄋ󰁤ノ
犳	犭󰁥勹丶
阈	门戈口󰀞
蹉	口止䒑工
忘	亠󰄃心󰁧
查	木日一󰀘
錾	车斤金󰀘
俘	亻爫子󰀝
猾	犭ノ󰀾月
胪	月󰀥尸ノ
匾	匚丶尸艹
堆	土亻󰁷󰀝
濠	氵󰁸冖󰀓
厦	厂丆目夂
皂	白七󰀅
住	亻丶王󰀝
刁	𠃌󰀞󰀌
恪	忄夂口󰀝
翘	弋丿一羽
蟥	虫󰁺由八
挤	扌文󰀯󰀢
松	木八厶󰁶
脬	月爫子󰀝
舀	爫臼󰀘
咯	口夂口󰀝
泯	氵󰁃󰁐弋
崩	山月月󰀘
淝	氵月巴󰁀
煊	火宀一一
蚣	虫八厶󰁶
奴	女又󰁶
杂	九木󰁧
芭	艹巴󰀅
倍	亻立口󰀝
撙	扌丷西寸
颇	󰅌又丆贝
聆	耳人丶󰁻
碇	石宀一󰁾
恆	忄一丨一
砟	石𠂉丨二
窭	宀八米女
扬	扌ㄋ󰁤ノ
缘	纟彑󰀓󰁶
抿	扌󰁃󰁐弋
馥	禾日𠂉夂
灾	宀火󰁧
尸	尸󰁈一丿
热	扌九丶灬
端	立山丆〢
艳	三丨⺈巴
磐	丿󰁪几石
突	宀八犬󰁧
答	⺮人一口
骁	󰀊󰀞弋儿
留	󰁚丶刀田
镙	钅田幺小
涵	氵了󰀪凵
蕙	艹一日心
趵	口止勹丶
畴	田三丿寸
茁	艹凵山󰀬
幌	冂丨日儿
疤	疒巴󰁫
疟	疒匚一󰀌
循	彳⺁十目
鞴	廿󰀜󰁺用
鳗	󰁢󰀞日又
骸	󰀾月亠人
硇	石丿囗乂
颈	ス工丆贝
袈	力口亠
易	日勹󰁤󰁣
佘	人二小󰁧
冤	冖⺈口丶
潘	氵丿米田
劬	勹口力ノ
蓁	艹三人禾
肾	〢又月󰀘
顿	一凵󰁐贝
驭	󰀊󰀞又󰁶
嫁	女宀豕
琼	王󰁸小󰁶
犀	尸氺󰅎丨
技	扌十又󰁶
髁	󰀾月日木
哕	口山夕󰁶
渍	氵主贝󰁶
贻	贝厶口󰀝
邑	口巴󰀅
冫	冫丶󰀞
疴	疒丁口󰀌
赵	土󰁾乂
蒯	艹月月刂
垆	土󰀥尸ノ
青	主月󰀘
陋	阝一冂󰄃
雒	夂口亻󰁷
蚪	虫󰁦十󰀢
裂	一夕刂󰀔
痿	疒禾女󰀌
祈	礻󰁶斤󰀢
酏	西一也󰁀
萝	艹罒夕󰁧
怕	忄白󰀝
烤	火土丿ㄅ
溘	氵土厶皿
夥	日木夕夕
亘	一日一󰀘
稿	禾󰁸冂口
遗	口丨一辶
材	木󰀛丿ノ
缑	纟亻ユ大
臬	丿目木󰁧
橥	犭ノ土木
锦	钅白冂丨
臾	臼人󰀦
蓑	艹亠口󰀔
旆	方𠂉一丨
褴	衤󰁧〢皿
铴	钅氵ㄋ󰁤
贵	口丨一贝
坐	人人土󰀌
洵	氵勹日󰀝
丬	丬丶󰀞丨
孚	爫子󰀘
鸫	󰀂小勹一
犬	犬一丿丶
犴	犭ノ干󰀢
鸸	丆冂〢一
输	车人一刂
鲇	󰁢󰀞󰀥口
鼾	丿目田干
呆	口木󰁧
狂	犭ノ王󰀝
妯	女由󰀝
戬	一󰅊一戈
愤	忄十艹贝
绘	纟人二厶
付	亻寸󰁶
域	土戈口󰀞
戾	丶尸犬󰀦
跸	口止󰁴十
裥	衤󰁧门日
默	󰀹土灬犬
秭	禾丿ㄅ丿
般	丿󰁪几又
舾	丿󰁪西󰀝
槿	木廿口主
猕	犭ノ弓小
诏	讠刀口󰀝
锴	钅󰁴匕白
鲸	󰁢󰀞亠小
兮	八一ㄅ󰀅
佑	亻口󰀝
砑	石󰀂亅丿
泵	石水󰁧
荽	艹爫女󰀘
椒	木上小又
丘	󰅍一󰀌
孜	孑夂󰁶
孙	孑小󰁶
盆	八刀皿󰀘
屹	山𠂉乙󰁀
尖	小大󰁧
挫	扌人人土
薅	艹女厂寸
缧	纟田ㄠ小
熙	匚丨口灬
觞	⺈用𠂉󰁤
尾	尸丿二乚
叁	厶大三󰀘
尿	尸水󰀦
獭	犭ノ一贝
谮	讠󰀂󰁜日
辑	车口耳󰀝
捭	扌白丿十
殉	一夕勹日
牵	大冖󰅎
辊	车日󰁴匕
安	宀女󰀘
幂	冖日大丨
钟	钅口丨󰀢
菈	艹扌立󰀘
砉	三丨石󰀘
漯	氵田ㄠ小
帘	宀八冂丨
侑	亻月󰀝
窥	宀八二󰁜
榀	木口口口
莽	艹犬廾󰀬
篾	⺮罒厂丶
禀	亠囗口小
璧	尸口立丶
晾	日󰁸小󰁶
瓤	亠口口󰂃
沣	氵三丨󰀢
褚	衤󰁧土日
膻	月亠囗一
番	丿米田󰀘
灌	氵艹口󰁷
抑	扌󰁚卩󰀢
悝	忄日土󰀝
诖	讠土土󰀝
滟	氵三丨巴
诮	讠⺌月󰀝
篮	⺮〢𠂉皿
逗	一口䒑辶
近	斤辶󰀵
痄	疒𠂉丨二
授	扌爫冖又
痧	疒氵小丿
裾	衤󰁧尸古
鹘	󰀾月勹一
恝	三丨刀心
跪	口止⺈⺋
诉	讠斤丶󰁶
措	扌󰁺日󰀝
护	扌丶尸ノ
瑟	王王心丿
芤	艹孑乚󰀅
诫	讠戈廾󰀢
杰	木灬󰁧
瘟	疒日皿󰀌
瘪	疒丿目匕
血	丿皿󰀌
拽	扌日󰅅ノ
桀	夕󰀂丨木
础	石凵山󰀢
出	凵山󰀵
胯	月大二ㄅ
恹	忄厂大丶
翻	丿米田羽
角	⺈用󰀬
讫	讠𠂉乙󰁀
独	犭ノ虫󰁶
括	扌丿古󰀝
帑	女又冂丨
渑	氵口日乚
猓	犭󰁥曰木
丑	󰁈土󰀌
谚	讠立丿彡
骶	󰀾月󰁚丶
摈	扌宀󰅍八
盟	日月皿󰀘
目	目目目目
直	十󰀣󰀘
莅	艹亻立󰀘
锟	钅日󰁴匕
蔟	艹方𠂉大
生	丿主󰀌
栢	木丆日󰀝
虐	󰅋七匚一
堀	土尸凵山
驾	力口马
迎	󰁚卩辶󰀵
巨	匚󰁃󰀌
挽	扌⺈口󰁜
煽	火丶尸羽
砀	石ㄋ󰁤ノ
栀	木⺁一⺋
訾	止匕言󰀘
丨	丨丨〇〇
怡	忄厶口󰀝
瞟	目覀二小
瞧	目亻󰁷灬
肥	月巴󰁀
薜	艹尸口辛
竭	立日勹󰄃
婶	女宀日丨
髭	󰂞彡止匕
焯	火󰀥早󰀢
矍	目目亻又
屉	尸廿󰄃󰁫
舵	丿󰁪宀匕
究	宀八九󰀅
汉	氵又󰁶
掩	扌大日乚
豉	一口䒑又
铟	钅囗大󰁶
研	石一廾󰀢
霞	󰀙󰁃丨又
鹑	󰁸孑󰁠一
蹑	口止耳又
淘	氵勹󰅎山
命	人一口卩
派	氵⺁󰀕󰁶
砥	石󰁚󰀁丶
葩	艹白巴󰀅
检	木人
烽	火夂三丨
宥	宀月󰀘
郇	勹日阝󰀢
卅	一川󰀵
弈	亠󰁖廾󰀬
薏	艹立日心
缈	纟目小丿
急	⺈彐心󰁧
倥	亻宀八工
牌	丿丨一十
贾	覀贝󰁧
辎	车巛田󰀝
云	二厶󰁧
庑	广二󰁜󰁫
蘸	艹西一灬
贮	贝宀一󰀝
碚	石立口󰀝
洮	氵儿󰀪󰁶
瑭	王广󰁬口
绷	纟月月󰀝
斟	艹三八十
贶	贝口儿󰁀
荤	艹冖车󰀬
盐	土卜皿󰀘
蛐	虫ㄇ󰁺󰀝
廷	丿士廴󰀌
眩	目亠ㄠ󰁶
泾	氵ス工󰀝
咽	口囗大󰁶
儇	亻罒一󰀔
阮	阝二儿󰁀
镏	钅󰁚丶田
客	宀夂口󰀘
颀	斤丆贝󰁶
嵘	山艹冖木
烹	󰁸了灬󰁧
敏	𠂉母夂󰁶
畏	田一󰀖󰁧
辫	辛纟辛󰀢
龟	⺈日乚󰀅
钽	钅日一󰀝
蒽	艹囗大心
萌	艹日月󰀘
咭	口士口󰀝
搌	扌尸󰁺󰀖
滑	氵󰀾月󰀝
廑	广廿口主
钭	钅󰁦十󰀢
祆	礻󰁶一大
镩	钅宀八丨
播	扌丿米田
步	止󰀤󰁣
祟	凵山二小
赘	主󰁡夂贝
镟	钅方𠂉󰁾
锌	钅辛󰀢
绑	纟三丿阝
龊	止人凵󰁾
隐	阝⺈彐心
揽	扌〢𠂉󰁜
禁	木木二小
菽	艹上小又
艹	艹一丨丨
岘	山ㄇ󰁜󰁀
禅	礻󰁶丷十
批	扌󰁴匕󰁀
阏	门方人󰁦
禳	礻󰁶亠󰀔
雌	止󰁴亻󰁷
缁	纟巛田󰀝
嘏	古󰁃丨又
弁	厶廾󰀬
杀	乂木󰁧
秂	禾人󰁧
企	人止󰀘
叭	口八󰁶
揭	扌日勹󰄃
班	王丶丿王
议	讠丶乂󰁶
衲	衤󰁧冂人
于	一󰀛󰀵
衹	衤󰁧󰁚󰀁
啐	口亠人十
队	阝人󰁶
苤	艹丆卜一
粘	米󰀥口󰀝
镐	钅󰁸冂口
彷	彳方ノ
架	力口木󰁧
吞	一大口󰀘
积	禾口八󰁶
签	⺮人一一
搽	扌艹人木
逞	口王辶󰀌
落	艹氵夂口
移	禾夕夕󰁶
嗟	口䒑󰀠工
要	覀女󰀘
檩	木亠囗小
终	纟夂󰁦󰁶
需	󰀙丆冂〢
蜀	罒勹虫󰁧
族	方𠂉𠂉大
最	日耳又󰁧
瑞	王山丆〢
鄞	廿口主阝
稽	禾乚日
搭	扌艹人口
吭	口亠几󰁀
罟	罒古󰀘
筮	⺮工人人
粞	米西󰀝
浑	氵冖车󰀢
唐	广󰁬丨口
阅	门丷口儿
陨	阝口贝󰁶
靶	廿󰀜巴󰁀
锐	钅丷口儿
童	立日土󰀘
铮	钅⺈󰁬亅
德	彳十罒心
衣	亠󰀔󰁧
肀	󰁬丨󰀵
谘	讠冫⺈口
粥	弓米弓󰁀
窳	宀八⺁󰂃
鲥	󰁢󰀞日寸
道	䒑丿目辶
嫦	女⺌冖丨
抟	扌二󰁓丶
尘	小土󰀘
谐	讠󰁴匕白
辁	车人王󰀝
氐	󰁚󰀁丶󰀦
鸾	亠󰁗勹一
岵	山古󰀝
茼	艹冂一口
征	彳一止󰀝
郓	冖车阝󰀢
鲵	󰁢󰀞臼儿
竺	⺮二󰀘
懈	忄⺈月󰀟
缉	纟口耳󰀝
火	火火火火
笄	⺮一廾󰀬
涑	氵一口󰅇
趟	土󰁾⺌口
趑	土󰁾冫人
询	讠勹日󰀝
笑	⺮丿大󰁧
踮	口止广口
啭	口车二丶
笥	⺮𠃌一口
迥	冂口辶󰀌
芍	艹勹丶󰁧
牟	厶󰅎丨
艟	丿󰁪立土
钤	钅人丶乛
锑	钅丷弓丿
疽	疒󰀐一󰀌
施	方𠂉也󰁀
巾	冂丨󰀵
撤	扌亠厶夂
獗	犭ノ厂人
翁	八厶羽󰀘
南	十冂䒑十
汐	氵夕󰁶
她	女也󰁀
咴	口火󰁶
菸	艹方人󰁦
揸	扌木日一
蒴	艹䒑凵月
钴	钅古󰀝
秉	丿一󰁬󰅇
箍	⺮扌匚丨
铐	钅土丿ㄅ
箪	⺮丷曰十
屎	尸米󰀦
淑	氵上小又
箸	⺮土丿日
跑	口止勹巳
纠	纟󰁐丨󰀢
篦	⺮丿囗匕
淮	氵亻󰁷󰀝
差	䒑󰀠工󰀘
谶	讠人人󰀞
簟	⺮覀早󰀬
剞	大丁口刂
瞅	目禾火󰁶
谥	讠䒑八皿
沾	氵󰀥口󰀝
挟	扌一丷大
尥	乚勹丶
粜	凵山米󰁧
隍	阝白王󰀝
诓	讠匚王󰀝
癀	疒󰁺由八
丁	丁一亅
币	丿冂丨󰀵
精	米主月󰀝
氵	氵丶丶󰀞
铽	钅弋心丶
陀	阝宀匕󰁀
扈	丶尸口巴
版	丿丨一又
鲶	󰁢󰀞人心
谵	讠⺈厂言
沮	氵󰀐一󰀝
粮	米丶彐󰀖
瘁	疒亠人十
鲮	󰁢󰀞土夂
蜿	虫宀夕⺋
羸	亠󰄃口丶
贽	扌九丶贝
髟	󰂞彡󰁥
职	耳口八󰁶
阊	门日日󰀌
鳕	󰁢󰀞󰀙彐
娉	女由一ㄅ
苞	艹勹巳󰀅
臻	一厶土禾
篥	⺮覀木󰁧
该	讠亠ㄥ人
寥	宀羽人彡
拟	扌󰁐丶人
红	纟工󰀝
约	纟勹丶󰁶
瘀	疒方人󰁦
昀	日勹冫󰀝
嘀	口亠丷古
纰	纟󰁴匕󰁀
毵	厶大彡乚
琴	王王人乛
鹁	十冖孑一
蹁	口止丶艹
钸	钅冂丨
戈	戈一󰁒丶
诵	讠󰁻用
绦	纟夂木󰁶
甭	丆卜用
痼	疒囗古󰀌
锭	钅宀一󰁾
鸽	人一口一
问	门口󰀌
迸	䒑廾辶󰀵
囿	囗月󰀌
替	二人二日
诟	讠⺁一口
俸	亻三人󰀟
婉	女宀夕⺋
赦	土󰁖夂󰁶
原	厂白小󰀦
颐	匚丨口贝
玟	王文󰁶
囡	囗女󰀌
镤	钅󰅊一人
蕤	艹一󰀓主
罢	罒土厶󰁧
迮	𠂉丨二辶
咗	口工󰀝
蝌	虫禾󰁦十
莺	艹冖勹一
羿	羽廾󰀬
钗	钅又丶󰁶
雀	小亻󰁷󰀘
谜	讠米辶󰁶
翊	立羽󰀝
哈	口人一口
沉	氵冖几
置	罒十󰀣󰀘
褶	衤󰁧羽白
锺	钅丿一土
汔	氵𠂉乙󰁀
福	礻󰁶一田
聃	耳冂土󰀝
部	立口阝󰀢
缮	纟丷󰅆口
胆	月日一󰀝
醌	西一日匕
铈	钅亠冂丨
镎	钅人一手
粉	米八刀ノ
貉	豸夂口󰀝
荬	艹乛󰁦大
卟	口卜󰁶
损	扌口贝󰁶
筘	⺮扌口󰀘
荟	艹人二厶
迢	刀口辶󰀌
莫	艹日大󰁧
菌	艹囗禾󰁧
萤	艹冖虫󰁧
呗	口贝󰁶
绁	纟廿󰄃󰁀
滁	氵阝人木
著	艹土丿日
蚀	⺈󰁐虫󰁶
磲	石氵匚木
筐	⺮匚王󰀘
泉	白水󰁧
况	冫口儿󰁀
蓟	艹󰁢󰀞刂
熵	火亠丷口
喽	口米女󰀝
吹	口⺈人󰁶
薤	艹一夕一
滞	氵一〣丨
绮	纟大丁口
填	土十󰀣八
藜	艹禾勹氺
鲚	󰁢󰀞文󰀯
逾	人一月辶
针	钅十󰀢
蒈	艹󰁴匕白
辜	古辛󰀬
窘	宀八󰁬口
擤	扌丿目󰀯
吟	口人丶乛
参	厶大彡󰁣
邴	一冂人阝
鲐	󰁢󰀞厶口
铤	钅丿士廴
败	贝夂󰁶
趾	口止止󰀝
岐	山十又󰁶
茗	艹夕口󰀘
猗	犭ノ大口
饭	⺈󰁐⺁又
剑	人一󰀧刂
暌	日癶一大
胄	由月󰀘
鲫	󰁢󰀞彐卩
桐	木冂一口
僵	亻一田一
效	六ㄨ攵
畀	田一󰀯󰀬
竞	立口儿󰀅
训	讠川󰀢
洁	氵士口󰀝
綮	丶尸夂小
袂	衤󰁧ユ人
闭	门󰀛丿󰀏
裟	氵小丿󰀔
畈	田⺁又󰁶
蕈	艹覀早󰀬
处	夂卜󰀦
涮	氵尸冂刂
泥	氵尸匕󰁀
褡	衤󰁧艹口
鞋	廿󰀜土土
峥	山⺈󰁬亅
鳐	󰁢󰀞爫山
觉	󰀧冖ㄇ󰁜
菟	艹⺈口丶
高	󰁸冂口󰀘
阽	阝󰀥口󰀝
泐	氵
狗	犭ノ勹口
苗	艹田󰀘
闹	门亠冂丨
腋	月亠亻丶
锔	钅尸𠃌口
饶	⺈󰁐弋儿
阐	门丷曰十
黑	󰀹土灬󰁧
鲡	󰁢󰀞一丶
销	钅⺌月󰀝
赁	亻丿士贝
赠	贝丷󰀺日
流	氵亠厶
超	土󰁾刀口
鸯	ㄇ大勹一
絮	女口ㄠ小
躁	口止口木
钹	钅又丶
赉	一米贝󰁧
隔	阝一口丨
浮	氵爫子󰀝
嘭	口士口彡
眾	罒亻人󰂃
蒨	艹亻月
〇	〇〇〇〇